א	אַלעף
אַבא	אַבע
אַבוהבֿ	אַבוהאַוו
אבן־פּקודה	איבן־פּעקודע,עוון־פּעקודע
אָבֿ	אָוו
אַבֿ־בית־דין	אַוו־בעזדן,אַוו־בעזן
אַבֿ־הרחמים	אַוו־האָראַכמים
אַבֿדה	אַוויידע
אַבֿדות	אַוויידעס
אָבֿות	אָוועס
אָבֿות־אַבֿותיו	אָוועס־אַווויסאָוו
אָבֿות־אַבֿותינו	אָוועס־אַווויסיינו
אַבֿי־אַבֿות־הטומאה	אַווי־אַוואָס־האַטומע
אַבֿי־יתומים	אַווי־יעסוימים
אַבֿיגדור	אַוויגדער
אַבֿיגדורן	אַוויגדערן
אַבֿיגדורס	אַוויגדערס
אבֿיון	עוויען
אבֿיונות	עוויוינעס
אבֿיונטע	עוויענטע
אבֿיונטעס	עוויענטעס
אבֿיונים	עוויוינים
אבֿיוניש	עוויויניש
אָבֿינו־מלכּנו	אָווינו־מאַלקיינו
אַבֿישלום	אַווישאָלעם
אַבֿישלומס	אַווישאָלעמס
אַבֿישלומען	אַווישאָלעמען
אָבֿל	אָוול
אָבֿל־וחפֿוי־ראָש	אָוול־וואַכאַפֿוּי־ראָש
אבֿל־ותוגה	אייוול־וועסוגע
אַבֿלות	אַוויילעס
אָבֿלטע	אָוולטע
אָבֿלטעס	אָוולטעס
אַבֿלים	אַוויילים
אבֿן	עוון
אבֿן־בוחן	עוון־בויכן
אבֿן־העזר	עוון־האָעזער
אבֿן־טובֿ	עוונטאָוו
אבֿן־נגף	עוון־נעגעף
אבֿן־עזרא	עוון־עזרע
אבֿני־נגף	אַוונע־נעגעף
אבֿנים־טובֿות	אַוואָנים־טויוועס
אבֿר	אייווער
אבֿר־מן־החי	אייווער־מין־האַכײַ
אַבֿרהם	אַווראָם
אַבֿרהם אָבֿינו	אַווראָהאָם אָווינו,אַווראָם אָווינו
אַבֿרהם אָבֿינוס	אַווראָהאָם אָווינוס,אַווראָם אָווינוס
אַבֿרהמל	אַוורעמל
אַבֿרהמלס	אַוורעמלס
אַבֿרהמלען	אַוורעמלען
אַבֿרהמס	אַווראָמס
אַבֿרהמען	אַווראָמען
אבֿרים	אייוורים
אַבֿשלום	אַוושאָלעם
אַבֿשלומס	אַוושאָלעמס
אַבֿשלומען	אַוושאָלעמען
אַגבֿ	אַגעוו
אַגבֿ־אורחא	אַגעוו־אורכע
אַגבֿ־אורחאדיק	אַגעוו־אורכעדיק
אַגדה	אַגאָדע
אַגדות	אַגאָדעס
אַגדתּא	אַגאַדעטע
אַגדתּות	אַגאַדעטעס
אַגודה	אַגודע
אַגודהניק	אַגודעניק
אַגודהניקעס	אַגודעניקעס
אַגודות	אַגודעס
אַגודת־ישׂראל	אַגודעס־ייִסראָעל
אָגיל־ואשׂמח	אָגל־וועעסמעך
אדום	עדעם
אדומי	עדוימי
אָדון	אָדן
אָדון־בפֿקדך	אָדן־בעפֿאָקדעכאָ
אָדון־הגדול	אָדן־האַגאָדל
אַדון־עולם	אַדוין־אוילעם
אַדוני	אַדויני
אַדונים	אַדוינים
אַדונים־הגדולים	אַדוינים־האַגדוילים
אַדוננו מורנו ורבנו	אַדויניינו מויריינו וועראַביינו
אַדיר	אַדיר
אַדירים	אַדירים
אָדם	אָדאָם,אָדעם
אָדם הראשון	אָדעם האָרישן
אַדמה	אַדאָמע
אַדמו״ר	אַדמאָר
אָדמס	אָדעמס
אָדמען	אָדעמען
אָדר	אָדער
אָדר א׳	אָדער אַלעף
אָדר ב׳	אָדער בייס
אָדר ואָדר	אָדער ווייאָדער
אַדרבא	אַדעראַבע,אַדראַבע
אַדרבא־ואַדרבא	אַדעראַבע־וועאַדעראַבע
אַדרבה	אַדעראַבע,אַדראַבע
אַדרבה־ואַדרבה	אַדעראַבע־וועאַדעראַבע
אַהבֿה	אַאַווע,אַהאַווע
אַהבֿה־רבה	אַאַווע־ראַבע,אַהאַווע־ראַבע
אַהבֿת־הבריות	אַאַוועס־האַבריִעס,אַהאַוועס־האַבריִעס
אַהבֿת־המקום	אַאַוועס־האַמאָקעם,אַהאַוועס־האַמאָקעם
אַהבֿת־ישׂראל	אַאַוועס־ייִסראָעל,אַהאַוועס־ייִסראָעל
אַהבֿת־נפֿש	אַאַוועס־נעפֿעש,אַהאַוועס־נעפֿעש
אָהלות	אָהאָלעס
אַהרן	אַרן
אַהרן הכּהן	אַרן האַקויען
אַהרנס	אַרנס
אוהבֿ־בצע	אויהעוו־בעצע,אויעוו־בעצע
אוהבֿ־ישׂראל	אויהעוו־ייִסראָעל,אויעוו־ייִסראָעל
אוהבֿי־ישׂראל	אויהעווע־ייִסראָעל,אויעווע־ייִסראָעל
אוהל	אויהעל,אויעל
אוהלים	אויהאָלים
אַוודאי	אַוואַדע
אַוויר	אַווער
אַווירט	אַווערט
אַווירן	אַווערן
אַווירנדיק	אַווערנדיק
אַווירסט	אַווערסט
אויסבטלען	אויסבאַטלען
אויסבטלענדיק	אויסבאַטלענדיק
אויסגעבטלט	אויסגעבאַטלט
אויסגעטענהט	אויסגעטײַנעט
אויסגעסדרט	אויסגעסאַדערט
אויסטענהן	אויסטײַנען
אויסטענהנדיק	אויסטײַנענדיק
אויססדרן	אויססאַדערן
אויססדרנדיק	אויססאַדערנדיק
אויסשגצן	אויסשייגעצן
אולי־ירחם	אולײַ־יעראַכעם
אומברחמנות	אומבעראַכמאָנעס
אומברחמנותדיק	אומבעראַכמאָנעסדיק
אומברחמנותדיקן	אומבעראַכמאָנעסדיקן
אומברחמנותדיקע	אומבעראַכמאָנעסדיקע
אומברחמנותדיקער	אומבעראַכמאָנעסדיקער
אומבתּרבותדיק	אומבעטאַרבעסדיק
אומבתּרבותדיקן	אומבעטאַרבעסדיקן
אומבתּרבותדיקע	אומבעטאַרבעסדיקע
אומבתּרבותדיקער	אומבעטאַרבעסדיקער
אומה	אומע
אומה־ולשון	אומע־וועלאָשן
אומות	אומעס
אומות־העולם	אומעס־האָוילעם
אומחן	אומכיין
אומן	אומען
אומן־יד	אומען־יאַד
אומנות	אומנעס
אומנותן	אומנעסן
אומר־ועושׂה	אוימער־וועויסע
אונטערגנבֿענען	אונטערגאַנווענען
אונטערגנבֿענענדיק	אונטערגאַנווענענדיק
אונטערגעגנבֿעט	אונטערגעגאַנוועט
אונטערצוגנבֿענען	אונטערצוגאַנווענען
אונטערקול	אונטערקאָל
אונס	אוינעס
אופֿן	אויפֿן
אופֿנים	אויפֿאַנים
אוצר	אויצער
אוצרות	אויצרעס
אוקינוס	אָקיאָנעס
אור	אויר
אור ליהודים	אויר לאַיעהודים
אור־הגנוז	אויר־האַגאָנעז
אור־כּשׂדים	אור־קאַזדים
אורח	אוירעך
אורח־הגון	אוירעך־האָגן
אורח־חיים	אוירעך־כאַיִם
אורחטע	אוירעכטע
אורחטעס	אוירעכטעס
אורחים	אָרכים
אורחים־הגונים	אָרכים־האַגונים
אוריאל	אוריִעל
אוריאלן	אוריִעלן
אוריאלס	אוריִעלס
אורים־ותּומים	אורים־וועטומים
אושפּיזין	אושפּיזן
אות	אָס
אות־באות	אָס־בעאָס
אותו־איש	אויסע־איש
אותו־האיש	אויסע־האָיִש
אותו־המקום	אויסע־האַמאָקעם
אותו־מקום	אויסע־מאָקעם
אותו־רגע	אויסע־רעגע
אותות־ומופֿתים	אויסעס־אומאָפֿסים
אותיות	אויסיעס
אותיות מחכּימות	אויסיעס מאַכקימעס
אותיות־מרובעות	אויסיעס־מערובאָעס
אותיותלעך	אויסיעסלעך
אָז־ישיר	אָז־יאָשער
אַזהרה	אַזהאָרע
אַזהרות	אַזהאָרעס
אָח־לצרה	אָך־לעצאָרע
אַחאָבֿ	אַכאָוו
אחד	עכאָד
אַחד־העם	אַכאַד־האָאָם
אַחדות	אַכדעס
אַחדות־הבורא	אַכדעס־האַבוירע
אַחוץ	אַכוץ
אָחור	אָכער
אַחוריים	אַכויראַיִם
אָחורס	אָכערס
אָחי	אָכי
אַחיזה	אַכיזע
אַחיזות	אַכיזעס
אַחיזת־עינים	אַכיזעס־איינאַיִם
אַחים־לצרה	אַכים־לעצאָרע
אַחינו־בני־ישׂראל	אַכיינו־בניי־ייִסראָעל
אַחר	אַכער
אַחר־המעשׂה	אַכער־האַמײַסע
אַחר־מאה־שנים	אַכער־מייע־שאָנים
אַחרון	אַכרען
אַחרון אַחרון חבֿיבֿ	אַכרען אַכרען כאָוויוו
אַחרון־של־פּסח	אַכרען־שעל־פּייסעך
אַחרונים	אַכרוינים
אַחרי־כּכלות־הכּל	אַכריי־קיכלויס־האַקל
אַחרי־מות	אַכריי־מויס
אַחריות	אַכרײַעס
אַחרית־הימים	אַכרעס־האַיאָמים
אַחשוורוש	אַכאַשוויירעש
אַחשתּרנים	אַכאַשטראָנים
אַחת־ואַחת	אַכאַס־וועאַכאַס
איבוד	איבעד
איבערגעחזרט	איבערגעכאַזערט
איבערחזרן	איבערכאַזערן
איבערחזרנדיק	איבערכאַזערנדיק
איובֿ	איִעוו
איובֿ־בשׂורה	איִעוו־בסורע,איִעוו־פּסורע
איובֿ־בשׂורות	איִעוו־בסורעס,איִעוו־פּסורעס
אייבערהסברה	אייבערהאַזבאָרע,אייבערהאַסבאָרע
אייבערהסברות	אייבערהאַזבאָרעס,אייבערהאַסבאָרעס
אייבערקול	אייבערקאָל
אײַנגעחושכט	אײַנגעכוישעכט
אײַנגעחושכטן	אײַנגעכוישעכטן
אײַנגעחושכטע	אײַנגעכוישעכטע
אײַנגעחושכטער	אײַנגעכוישעכטער
אײַנגעחזירט	אײַנגעכאַזערט
אײַנחזירן	אײַנכאַזערן
אײַנחזירנדיק	אײַנכאַזערנדיק
אייר	איִער
איכה	אייכע
איכות	אייכעס
אַילונית	אײַלעניס
אַילוניתן	אײַלעניסן
אימה	איימע
אימהדיק	איימעדיק
אימהדיקן	איימעדיקן
אימהדיקס	איימעדיקס
אימהדיקע	איימעדיקע
אימהדיקער	איימעדיקער
אימת־מוות	איימעס־מאָוועס
אימתא־דציבורא	איימעסע־דעציבורע
אין	איין
אין אונס	איין אוינעס
אין חכמה ואין תּבֿונה נגד	איין כאָכמע וועיין טוווּנע נעגעד
אין יוצא ואין באָ	איין יויצע וועיין באָ
אין מזל לישׂראל	איין מאַזל לעייִסראָעל
אין עצה ואין תּבֿונה	איין אייצע וועיין טוווּנע
אין קול ואין עונה	איין קאָל וועיין אוינע
אין־בית	איין־באַיִס
אין־ברירה	איין־בריירע
אין־לי	איין־לי
אין־לשער	איין־לעשאַער
אין־לשער ואין־לספּר	איין־לעשאַער וועיין־לעסאַפּער
אין־סוף	איינסאָף
אינו־ישׂראל	איינע־ייִסראָעל
אינו־ניראה	איינע־נירע
אינו־ניראהס	איינע־נירעס
איננו	איינענו
איסור	איסער
איסורים	איסורים
איסיי	איסיִיִ
איסיים	איסיִיִם
איסר	איסער
איסרו־חג	איסרע־כאַג
איפּכא־מסתּברא	איפּכע־מיסטאַברע
איפּכא־מסתּבראניצע	איפּכע־מיסטאַברעניצע
איפּכא־מסתּבראניצעס	איפּכע־מיסטאַברעניצעס
איפּכא־מסתּבראניק	איפּכע־מיסטאַברעניק
איפּכא־מסתּבראניקעס	איפּכע־מיסטאַברעניקעס
איצטלא־דרבנן	איצטעלע־דעראַבאָנען
איש	איש
איש־חשובֿ	איש־כאָשעוו
איש־ישר	איש־יאָשער
איש־מהימן	איש־מעהיימען
איש־מפּי־איש	איש־מעפּי־איש
אישה	אישע
אישה־צנועה	אישע־צנוע
איתמר	איסאָמער
אַכזר	אַכזער
אַכזריות	אַכזאָריעס
אַכזרים	אַכזאָרים
אַכילה	אַכילע
אַכילה־ושתּיה	אַכילע־אושטיִע
אַכל	אַכל
אַכלט	אַכלט
אַכלן	אַכלען
אַכלנים	אַכלאָנים
אַכלסט	אַכלסט
אַכלען	אַכלען
אַכלענדיק	אַכלענדיק
אַכסניא	אַכסאַניע
אַכסניה	אַכסאַניע
אַכסניות	אַכסאַניעס
אל	אייל
אַל	אַל
אַל תּסתּכּל בקנקן	אַל טיסטאַקל בעקאַנקן
אַל תּפֿתּח פּה לשׂטן	אַל טיפֿטאַך פּע לאַסאָטן
אַל תּשליכנו לעת־זיקנה	אַל טאַשליכיינו לעייס־זיקנע
אל־מלא־רחמים	אייל־מאָלע־ראַכמים
אל־נקמות	אייל־נעקאָמעס
אל־רחום־וחנון	אייל־ראַכום־וועכאַנון
אלא	עלאָ,עלע
אלא מאַי	עלאָ מאַ ,עלאָ מײַ,עלע מאַ,עלע מײַ
אלא מה	עלאָ מאַ ,עלאָ מײַ,עלע מאַ,עלע מײַ
אלה תּולדות	איילע טאָלדעס
אלול	עלעל
אלולדיק	עלעלדיק
אַלוף	אַלעף
אַלופֿים	אַלופֿים
אלחנן	עלכאָנען
אלחננס	עלכאָנענס
אלחננען	עלכאָנענען
אליה	עליע
אליהו	עליאָהו
אליהו הנבֿיא	עליאָהו האַנאָווי,עליעהאַנאָווע,עליענאָווע
אליהו הנבֿיאס	עליאָהו האַנאָוויס,עליעהאַנאָוועס
אליהון	עליאָהון
אליהוס	עליאָהוס
אליהן	עליען
אליהס	עליעס
אלימלך	עלימיילעך
אליעזר	עליעזער
אליעזרן	עליעזערן
אליעזרס	עליעזערס
אליקום	עליאָקעם
אלישע	עלישע
אלישע בן־אַבֿויה	עלישע בען־אַוווּיע
אלישען	עלישען
אלישעס	עלישעס
אַלכּסנדר	אַלעקסאַנדער
אַלכּסנדר מוקדון	אַלעקסאַנדער מאָקדן
אַלכּסנדרן	אַלעקסאַנדערן
אַלכּסנדרס	אַלעקסאַנדערס
אַלכסון	אַלאַכסן
אַלכסונס	אַלאַכסנס
אַלמאַי	אַלעמײַ
אַלמן	אַלמען
אַלמנה	אַלמאָנע
אלעזר	עלאָזער
אלעזרן	עלאָזערן
אלעזרס	עלאָזערס
אַלף	אַלעף
אלף	עלעף
אלף־אַלפֿים	עלעף־אַלאָפֿים
אַלף־בית	אַלעפֿבייס
אלף־השישי	עלעף־האַשישי
אַלפֿי־אַלפֿים	אַלפֿיי־אַלאָפֿים
אַלפֿים	אַלאָפֿים
אלקנה	עלקאָנע
אם	אים
אם לא יועיל לא יזיק	אים לוי יאָיִל לוי יאַזיק
אם לא עכשיו אימתי	אים לוי אַכשאָוו איימאָסײַ
אם־ירצה־השם	אים־ייִרצע־האַשעם,מירצעשעם,מערטשעם,מערצעשעם
אם־כּן	אימקיין
אמהות	אימאָעס
אמונה	עמונע
אמונה־שלמה	עמונע־שליימע
אמונות	עמונעס
אמור	עמער
אַמורא	אַמוירע
אַמוראָים	אַמויראָיִם
אָמן	אָמיין
אָמן וכן יהי רצון	אָמיין פֿכיין יעהי ראָצן
אָמן־סלה	אָמיין־סעלאָ
אַמנון	אַמנען
אָמר	אָמאַר
אמת	עמעס
אמת מארץ תּצמח	עמעס מעערעץ טיצמעך
אמת־ויציבֿ	עמעס־וועיאַצעוו
אמתדיק	עמעסדיק
אמתדיקן	עמעסדיקן
אמתדיקס	עמעסדיקס
אמתדיקע	עמעסדיקע
אמתדיקער	עמעסדיקער
אמתן	עמעסן
אמתע	עמעסע
אמתער	עמעסער
אָנגעשיכּורט	אָנגעשיקערט
אַנדרוגינוס	אַנדרויגינעס
אָנוכי	אָנויכי
אָנוס	אָנעס
אַנוסים	אַנוסים
אָנחזירן	אָנכאַזערן
אָנחידושן	אָנכידעשן
אַנטיוכוס	אַנטיִאָכעס
אַנטיוכוס הרשע	אַנטיִאָכעס האַראָשע
אַני שלמה	אַני שלוימע
אַני־הקטן	אַני־האַקאָטן
אַני־מאמין	אַני־מײַמען
אָנצושיכּורן	אָנצושיקערן
אנקת־מסלדיך	ענקעס־מעסאַלדעכאָ
אַנשי־	אַנשע
אַנשי־כּנסת־הגדולה	אַנשע־קנעסעס־האַגדוילע
אַנשי־מעשׂה	אַנשע־מײַסע
אַנשי־שלומנו	אַנשע־שלוימיינו
אָנשיכּורן	אָנשיקערן
אַנשים	אַנאָשים
אַנשים נשים וטף	אַנאָשים נאָשים וועטאַף
אַנשים־חשובֿים	אַנאָשים־כשוּווים,אַנאָשים־כאַשוּווים
אָסור	אָסער
אָסור־חזיר	אָסער־כאַזער
אָסור־לדבר	אָסער־לעדאַבער
אָסור־לרחם	אָסער־לעראַכעם
אַסורה	אַסורע
אַסורים	אַסורים
אַסותא	אַסוסע
אַסיפֿה	אַסיפֿע
אַסכּרה	אַסקערע
אַסמכתּא	אַסמאַכטע
אַסנה	אַסנע
אַסרן	אַסערן
אסתּר	עסטער
אסתּר המלכּה	עסטער האַמאַלקע
אסתּר־תּענית	עסטער־טאָנעס
אָפּגעחומרט	אָפּגעכוימערט
אַפּוטרופּוס	אַפּעטראָפּעס
אַפּוטרופּוסים	אַפּעטראָפּסים
אַפּוטרופּס	אַפּעטראָפּעס
אַפּוטרופּסות	אַפּעטראָפּסעס
אַפּוטרופּסים	אַפּעטראָפּסים
אַפּותּיקא	אַפּויטיקע,פּויטיקע
אַפּותּיקי	אַפּויטיקע,פּויטיקע
אָפּחורשן	אָפּכוירעשן
אָפּחושכן	אָפּכוישעכן
אָפּחיען	אָפּכײַען
אַפּיקורס	אַפּיקוירעס
אַפּיקורסות	אַפּיקאָרסעס
אַפּיקורסטע	אַפּיקוירעסטע
אַפּיקורסים	אַפּיקאָרסים
אַפּיקורסיש	אַפּיקאָרסיש
אַפּיקורסישן	אַפּיקאָרסישן
אַפּיקורסישע	אַפּיקאָרסישע
אַפּיקורסישער	אַפּיקאָרסישער
אָפּמשלען	אָפּמאָשלען
אַפּנים	 אַפּאָנעם
אָפּפּטרן	אָפּפּאַטערן
אַפּשיטא	אַפּשיטע
אפֿוד	אייפֿעד
אַפֿילו	אַפֿילע
אַפֿיקומן	אַפֿיקוימען
אפֿרוח	עפֿרויעך
אפֿרוחים	עפֿרויכים
אפֿרים	עפֿראָיִם
אפֿרימס	עפֿראָיִמס
אפֿרימען	עפֿראָיִמען
אפֿשר	עפֿשער
אָץ־קוצץ	אָץ־קויצעץ
אצבע־אלוהים	עצבע־עלאָקים,עצבע־עלויהים
אצבע־אלקים	עצבע־עלאָקים
אַצילות	אַצילעס
אַקדמות	אַקדאָמעס
אַראָפּגעפּטרט	אַראָפּגעפּאַטערט
אַראָפּפּטרן	אַראָפּפּאַטערן
אַרבה	אַרבע
אַרבע־כּוסות	אַרבע־קויסעס
אַרבע־כּנפֿות	אַרבעקאַנפֿעס
אַרבע־כּנפֿותל	אַרבעקאַנפֿעסל
אַרבע־מיתות־בית־דין	אַרבע־מיסעס־בעזדן,אַרבע־מיסעס־בעזן
אַרבע־פּינות־העולם	אַרבע־פּינעס־האָוילעם
אַרבע־רוחות	אַרבע־רוכעס
אַרבע־רוחות־העולם	אַרבע־רוכעס־האָוילעם
אַרבעה־בנים	אַרבאָע־באָנים
אַרבעה־טורים	אַרבאָע־טורים
אַרבעים	אַרבאָיִם
אַרויסגנבֿענען	אַרויסגאַנווענען
אַרויסגעגנבֿעט	אַרויסגעגאַנוועט
אַרויסגעלקחנט	אַרויסגעלאַטכנט
אַרויסגעמשלחט	אַרויסגעמעשאַלייעכט
אַרויסלקחנען	אַרויסלאַטכענען
אַרויסמשלחן	אַרויסמעשאַלייעכן
אַרויספּטרן	אַרויספּאַטערן
אָרון	אָרן
אָרון־קודש	אָרנקוידעש
אַרונות	אַרוינעס
אָרור	אָרער
אַרורה	אַרורע
אַרורים	אַרורים
אָרחי־פּרחי	אָרכעפּאָרכע
אַר״י	אַרי
אַרי־שבחבֿורה	אַרי־שעבאַכאַוווּרע
אַריבערגנבֿענען	אַריבערגאַנווענען
אַריבערגעגנבֿעט	אַריבערגעגאַנוועט
אַריבערצוגנבֿענען	אַריבערצוגאַנווענען
אַריה	אַריע
אַריהן	אַריען
אַריהס	אַריעס
אַרײַנגנבֿענען	אַרײַנגאַנווענען
אַרײַנגעגנבֿעט	אַרײַנגעגאַנוועט
אַרײַנישבֿען	אַרײַניאַשווען
אַרײַנישבֿענען	אַרײַניאַשווענען
אַרײַנצוגנבֿענען	אַרײַנצוגאַנווענען
אַריכות־ימים	אַריכעס־יאָמים
אַרם	אַראַם
אַרם־נהרים	אַראַם־נאַהאַראַיִם
אַרמי	אַראַמי
אַרמיש	אַראַמיש
אָרעם־בחור	אָרעם־באָכער
ארץ	ערעץ
ארץ־ישׂראל	ערעץ־ייִסראָעל
ארץ־ישׂראל־פֿעדעם	ערעץ־ייִסראָעל־פֿעדעם
אָרצה	אָרצע
אַררט	אַראָראַט
אש־להבֿה	אייש־לעהאָווע
אַשור	אַשור
אַשכּנז	אַשקענאַז
אַשכּנזי	אַשקענאַזי
אַשכּנזים	אַשקענאַזים
אַשכּנזיש	אַשקענאַזיש
אַשכּנזער	אַשקענאַזער
אַשמדאַי	אַשמעדײַ
אַשמורה	אַשמוירע
אָשמנו	אָשאַמנו
אָשמנו בגדנו גזלנו	אָשאַמנו באָגאַדנו גאָזאַלנו
אַשפּה	אַשפּע
אָשר	אָשער
אַשר לא …ו אַבֿותנו	אַשער לוי …ו אַווויסיינו
אַשר־יצר	אַשער־יאָצער
אַשר־יצר־פּאַפּיר	אַשעריאָצער־פּאַפּיר
אַשר־יצרל	אַשער־יאָצערל
אַשרי	אַשריי
אַשרי המאמין	אַשריי האַמײַמען
אָשרן	אָשערן
אָשרס	אָשערס
אשת־איש	איישעס־איש
אשת־אישניצע	איישעס־אישניצע
אשת־אישניצעס	איישעס־אישניצעס
אשת־אישניק	איישעס־אישניק
אשת־אישניקעס	איישעס־אישניקעס
אשת־חיל	איישעס־כאַיִל
אַתּה	אַטאָ,אַטע
אַתּה־בחרתּנו	אַטאָ־בעכאַרטאָנו
אַתּה־בחרתּנוניק	אַטאָ־בעכאַרטאָנוניק
אַתּה־בחרתּנוניקעס	אַטאָ־בעכאַרטאָנוניקעס
אַתּה־בֿחרתּנו	אַטאָ־וועכאַרטאָנו
אַתּה־הראית	אַטאָ־האָרייסאָ
אַתּה־הראיתלע	אַטאָ־האָרייסאָלע
אַתחלתּא־דגאולה	אַסכאַלטע־דעגעולע
אתרוג	עסרעג
אתרוגים	עסרויגים
אתרוגל	עסרעגל
ב…	באַ…,בי…,בע…
ב	בייז,בייס
בא	בוי
באַדמען	באַדאַמען
באַהבֿה	בעאַהאַווע
באָו מים עד נפֿש	באָו מאַיִם אַד נעפֿעש
באונס	בעוינעס
באופֿן	בעויפֿן
באותה־שעה	בעויסע־שאָ
באותו־הרגע	בעויסע־האַרעגע
באותו־מעמד	בעויסע־מײַמעד
באותו־רגע	בעויסע־רעגע
באָזני שמעתּי	באָזנײַ שאָמאַטי,בעאָזנײַ שאָמאַטי
באַחנט	באַכיינט
באַטעמט	באַטאַמט
באין־אופֿן	בעיין־אויפֿן
באין־ברירה	בעיין־בריירע
באיסור	בעיִסער
באַכילה	באַאַכילע
באַלכסון	באַלאַכסן
באלף־מחילות	בעעלעף־מעכילעס
באם	בעיִם
באמונה	בעעמונע
באמונה־שלמה	בעעמונע־שליימע
באמונתי	בעעמונאָסי
באמת	בעעמעס
באַעוולען	באַאַוולען
באַריכות	באַריכעס
באשר	באַנשער,באַשער
באשר־בכן	באַנשער־בעכיין,באַשער־בעכיין
בבֿא־בתרא	באָווע־באַסרע
בבֿא־מעשׂה	באָבע־מײַסע,באָווע־מײַסע
בבֿא־מציעא	באָווע־מעציִע
בבֿא־קמא	באָווע־קאַמע
בבֿחינת	ביפֿכינעס
בבֿל	באָוול
בבֿל־סחורה	באָוול־סכוירע
בבֿל־קונה	באָוול־קוינע
בבֿל־קונים	באָוול־קוינים
בבֿלי	באַוולי
בבֿת־אַחת	בעוואַס־אַכעס
בגד	בעגעד
בגדי־דלות	ביגדע־דאַלעס
בגדי־יום־טובֿ	ביגדע־יאָנטעוו
בגדי־כּהונה	ביגדע־קעהונע
בגדי־מלכות	ביגדע־מאַלכעס
בגדי־משי	ביגדע־מעשי
בגדי־שבת	ביגדע־שאַבעס
בגדים	בעגאָדים
בגדנו	באָגאַדנו
בגזלה	ביגזיילע
בגזרת־	ביגזיירעס
בגידה	בגידע
בגידה־במלכות	בגידע־בעמאַלכעס
בגילה ברינה	בעגילע בערינע
בגילוי	בעגילע
בגילוי־ראָש	בעגילע־ראָש
בגילופֿין	בעגילופֿן
בגימטריא	בעגימאַטריע
בגימטריה	בעגימאַטריע
בגלוי	בעגאָלע
בגנבֿה	ביגנייווע
בגפּו יבֿוא בגפּו יצא	בעגאַפּע יאָווע בעגאַפּע יייצע
בדוחק	בעדויכעק
בדוק־ומנוסה	באָדעק־אומענוסע
בדחילו־ורחימו	ביטכילע־אורכימע
בדחן	באַדכן,באַטכן
בדחנות	באַדכאָנעס,באַטכאָנעס
בדחנים	באַדכאָנים,באַטכאָנים
בדחניש	באַדכאָניש,באַטכאָניש
בדחנען	באַדכענען,באַטכענען
בדידי הווה עובֿדה	בעדידי האַווע אוּוודע
בדיוק	בעדיִעק
בדיל־דל	בעדילאַדאַל
בדיל־הדל	בעדילאַדאַל
בדיעבֿד	בעדיִעוועד
בדיקה	בדיקע
בדיקת־חמץ	בדיקעס־כאָמעץ
בדלות	בעדאַלעס
בדליכּאָ	בידעלייקאָ
בדמיך חיי	בעדאָמאַיִך כאַיִ
בדמעות־שליש	בידמאָעס־שאָלעש
בדעה	בעדייע
בדעה־אַחת	בעדייע־אַכעס
בדעת	בעדאַס
בדק־הבית	בעדעק־האַבאַיִס
בדקען	באַטקען
בדקענען	באַטקענען
בדרך־אַגבֿ	בעדערעך־אַגעוו
בדרך־גוזמא	בעדערעך־גוזמע
בדרך־הטבֿע	בעדערעך־האַטעווע
בדרך־הלצה	בעדערעך־האַלאָצע
בדרך־כּלל	בעדערעך־קלאַל
בדרך־משל	בעדערעך־מאָשל
בדרך־נס	בעדערעך־נעס
בהבֿל־פּיהם	בעהעוול־פּיהעם
בהדרגה	בעהאַדראָגע
בהיסח־הדעת	בעהעסעך־האַדאַאַס
בהיתּר	בעהעטער
בהכנעה	בעהאַכנאָע
בהכרח	בעהעכרעך
בהלה	בעהאָלע
בהלוואה	בעהאַלוואָע
בהמה	בעהיימע
בהמה בצורת־אָדם	בעהיימע בעצורעס־אָדעם
בהמה־גסה	בעהיימע־גאַסע
בהמה־דקה	בעהיימע־דאַקע
בהמהלע	בעהיימעלע
בהמהלעך	בעהיימעלעך
בהמות	בעהיימעס
בהן־צידקי	בעהען־צידקי
בהן־שלי	בעהען־שעלי
בהסכּם	בעהעסקעם
בהסכּם־כּולם	בעהעסקעם־קולעם
בהעלותך	בעהאַאַלויסכע
בהקיץ	בעהאָקעץ
בהקפֿה	בעהאַקאָפֿע
בהר	בעהאַר
בהרחבֿה	בעהאַרכאָווע
בהתמדה	בעהאַסמאָדע
בוגד	בויגעד
בוגדים	באָגדים
בוגר	בויגער
בוגרים	באָגרים
בוגרת	באָגרעס
בודק	בוידעק
בודק־חמץ	בוידעק־כאָמעץ
בוודאי	בעוואַדע
בוחר	בויכער
בולט	בוילעט
בועה	בוּע
בועז	בויעז
בועל	בויעל
בוקע־רקיעים	בויקייע־רעקיִיִם
בור	בור
בור־דאורײַתא	בור־דעוירײַסאָ,בורים־דעוירײַסאָ
בור־סוד	באָר־סוד
בורא	בוירע
בורא־מאורי־האש	בוירע־מעוירע־האָייש
בורא־עולם	בוירע־אוילעם
בורא־פּרי־האַדמה	בוירע־פּרי־האָאַדאָמע
בורא־פּרי־הגפֿן	בוירע־פּרי־האַגאָפֿן
בורח	בוירייעך
בורחים	באָרכים
בורים	בורים
בורר	בוירער
בוררות	באָרערעס
בוררים	באָרערים
בושה	בושע
בושת־פּנים	בוישעס־פּאָנעם
בושת־פּנימער	בוישעס־פּענעמער
בזה ובֿבֿאָ	באַזע אוּוואַוואָ
בזה־האופֿן	בעזע־האָויפֿן
בזה־הלשון	בעזע־האַלאָשן
בזוי	באָזע
בזויים	בזויִם
בזול	בעזאָל
בזי־בזיון	ביזע־ביזויען
בזי־בזיונות	ביזע־ביזיוינעס
בזיון	ביזויען
בזיונות	ביזיוינעס
בזיל־הזול	בעזיל־האַזאָל
בזיל־זול	בעזיל־זאָל
בזכות	ביסכוס
בזכות־זה	ביסכוס־זע
בזעיר־אַנפּין	ביזייר־אַנפּין
בזעת־אַפּיך	בעזייעס־אַפּעכאָ
בחבֿרותא	בעכאַוורוסע
בחדר״ג	בעכאַדראַג
בחדרי־חדרים	בעכאַדרע־כאַדאָרים
בחומר־ובֿלבֿנים	בעכוימער־אוּווילוויינים
בחור	באָכער
בחור־הזעצער	באָכער־האַזעצער
בחורווײַז	באָכערווײַז
בחורטע	באָכערטע
בחורים	באַכורים,באָכערים
בחורימלעך	באָכערימלעך
בחורל	באָכערל
בחורס	באָכערס
בחורעץ	באָכערעץ
בחוש	בעכוש
בחזקה	בעכאַזאָקע
בחזקת־	בעכעסקעס
בחזרה	בעכאַזאָרע
בחיי אבן־פּקודה	בעכײַע עוון־פּעקודע
בחינה	בכינע,פּכינע
בחינות	פּכינעס
בחינם	בעכינעם
בחיר	בכיר,פּכיר
בחירה	בכירע,פּכירע
בחפּזון	בעכיפּאָזן
בחצי־חינם	בעכאָצע־כינעם
בחקותי	בעכוקויסײַ
בחרם	בעכיירעם
בחרפּה	בעכאַרפּע
בחרפּתו	בעכאַרפּאָסע
בחשיבֿות	ביכשיוועס
בטבֿע	בעטעווע
בטוח	בעטועך
בטוחות	בעטוכעס
בטוחים	בעטוכים
בטחון	ביטאָכן
בטל	באָטל,באַטל
בטל־בשישים	באָטל־בעשישים
בטל־ומבֿוטל	באָטל־אומוווּטל
בטלט	באַטלט
בטלן	באַטלען
בטלנות	באַטלאָנעס
בטלנים	באַטלאָנים
בטלניש	באַטלאָניש
בטלסט	באַטלסט
בטלען	באַטלען
בטלענען	באַטלענען
ביאה	ביִע
ביאור	ביִער
ביאורים	ביִורים
ביאת־הגואל	ביִעס־האַגויעל
ביד	בעיאַד
ביד־חזקה	בעיאַד־כאַזאָקע
ביד־רחבֿה	בעיאַד־רעכאָווע
ביד־רחבֿה־ומלאה	בעיאַד־רעכאָווע־אומלייע
ביד־רמה	בעיאַד־ראָמע
בידים	בעיאָדאַיִם
ביודעים	בעיוידים
ביוקר	בעיויקער
ביוש	ביִעש
ביחידות	ביכידעס
ביטול	ביטל
ביטול־אבֿרים	ביטל־אייוואָרים,ביטל־אייוורים
ביטול־היש	ביטל־האַיעש
ביטול־תּורה	ביטל־טוירע
בײַשן	בײַשן
בײַשנות	בײַשאָנעס
בײַשנים	בײַשאָנים
ביכּורים	ביקורים
ביכולת	ביכוילעס
בילבול	בילבל
בילבול־דם	בילבל־דאַם
בילבול־המוחות	בילבל־האַמויכעס
בילבולים	בילבולים
ביל״ו	בילו
בילתּי	בילטי
בילתּי־מסופּק	בילטי־מעסופּעק
בימה	בימע
בימי	בימיי
בימים־ההם	באַיאָמים־האָהיים
בימקום	בימקעם
בין	ביין
בין אָדם לחבֿרו	ביין אָדעם לעכאַוויירע
בין אָדם למקום	ביין אָדעם לאַמאָקעם
בין ימינו ושׂמאלו	ביין יעמינע אוסמוילע
בין ימינו לשׂמאלו	ביין יעמינע ליסמוילע
בין־הזמנים	ביין־האַזמאַנים
בין־המצרים	ביין־האַמצאָרים
בין־השמשות	ביין־האַשמאָשעס
בין־כּסא־לעשׂור	ביין־קעסע־לעאָסער
בין־מינחה־למעריבֿ	ביין־מינכע־לעמײַרעוו
בינה	בינע
בינו־לבינו	ביינע־לעביינע
בינם	בינעם
בינמס	בינעמס
בינמען	בינעמען
ביעור־חמץ	ביִער־כאָמעץ
ביצה	בייצע
ביצים	בייצים
ביקור־חולים	ביקער־כוילים
בירושה	בעיערושע
ביתּ״ר	בעטאַר
ביתּר	בעטאַר,בעטער
בית	בייז,בייס
בית־	בייס
בית־דין	בעזדן,בעזן
בית־דין־צדק	בעזדן־צעדעק,בעזן־צעדעק
בית־דין־שטוב	בעזדן־שטוב,בעזן־שטוב
בית־דין־של־מעלה	בעזדן־שעל־מײַלע,בעזן־שעל־מײַלע
בית־דין־שמשׂ	בעזדן־שאַמעס,בעזן־שאַמעס
בית־דין־שמשׂים	בעזדן־שאַמאָסים,בעזן־שאַמאָסים
בית־החיים	בייס־האַכאַיִם
בית־הכּבֿוד	בייס־האַקאָוועד
בית־הכּיסא	בייס־האַקיסע
בית־הכּנסת	בייס־האַקנעסעס
בית־המדרש	בייס־האַמעדרעש
בית־המיקדש	בייס־האַמיגדעש
בית־הקבֿרות	בייס־האַקוואָרעס
בית־וועד	בייס־וואַאַד
בית־וועד־ל…	בייס־וואַאַד־לאַ…
בית־וועד־לחכמים	בייס־וואַאַד־לאַכאַכאָמים
בית־יעקבֿ	בייס־יאַנקעוו
בית־יעקבֿ לכו ונלכה	בייס־יאַנקעוו לעכו וועניילכאָ
בית־יתומים	בייס־יעסוימים
בית־לחם	בייס־לעכעם
בית־מדרש	בעסמעדרעש
בית־מדרשל	בעסמעדרעשל
בית־עולם	בעסוילעם
בית־עלמין	בעסאַלמען
בית־ראשון	באַיִס־רישן
בית־שני	באַיִס־שייני
בכּאַן	בעקאַן
בכּבֿוד	בעקאָוועד
בכּבֿוד־גדול	בעקאָוועד־גאָדל
בכּבֿודיק	בעקאָוועדיק
בכּבֿודיקן	בעקאָוועדיקן
בכּבֿודיקס	בעקאָוועדיקס
בכּבֿודיקע	בעקאָוועדיקע
בכּבֿודיקער	בעקאָוועדיקער
בכּבֿודיקערן	בעקאָוועדיקערן
בכּבֿודיקערס	בעקאָוועדיקערס
בכּבֿודיקערע	בעקאָוועדיקערע
בכּבֿודיקערער	בעקאָוועדיקערער
בכּובֿד־ראָש	בעקויוועד־ראָש
בכּוונה	בעקאַוואָנע
בכּוח	בעקויעך
בכּיוון	בעקיוון
בכּיסו בכּוסו בכּעסו	בעקיסע בעקויסע בעקײַסע
בכּל־מכּל־כּל	באַקל־מיקל־קאָל
בכּלל	ביקלאַל
בכּתבֿ	ביקסאַוו
בכבֿודה־ובֿעצמה	ביכוווידע־אוּוועאַצמע
בכבֿודו־ובֿעצמו	ביכוווידע־אוּוועאַצמע
בכדי	ביכדיי
בכור	בכאָר,פּכאָר
בכורה	בכוירע,פּכוירע
בכורות	בכוירעס,פּכוירעס
בכורטע	בכאָרטע,פּכאָרטע
בכורטעס	פּכאָרטעס
בכורים	בכוירים,פּכוירים
בכי־טובֿ	בעכי־טויוו
בכיה	בכיִע,פּכיִע
בכיה־לדורות	בכיִע־לעדוירעס,פּכיִע־לעדוירעס
בכל־אופֿן	בעכאָל־אויפֿן
בכל־תּפֿוצות־ישׂראל	בעכאָל־טפֿוצעס־ייִסראָעל
בכלל	ביכלאַל
בכן	בעכיין,בעכען
בל־תּשחית	באַל־טאַשכיס
בלא	בעלוי
בלא־גוזמא	בעלוי־גוזמע
בלא־יודעים	בעלוי־יוידים
בלבֿ־ונפֿש	בעלעוו־וואָנעפֿעש
בלהה	בילהע
בלחש	בעלאַכעש
בלי־	בלי,בעלי
בלי־גוזמא	בלי־גוזמע,בעלי־גוזמע
בלי־חרטה	בלי־כאַראָטע,בעלי־כאַראָטע
בלי־יפֿונה	בלי־יעפֿונע,בעלי־יעפֿונע
בלי־כּוונה	בלי־קאַוואָנע,בעלי־קאַוואָנע
בלי־מסקנא	בלי־מאַסקאָנע,בעלי־מאַסקאָנע
בלי־נדר	בלי־ניידער,בעלי־ניידער
בלי־ספֿק	בלי־סאָפֿעק,בעלי־סאָפֿעק
בלי־שום־טענה	בלי־שום־טײַנע,בעלי־שום־טײַנע
בלי־שום־ספֿק	בלי־שום־סאָפֿעק,בעלי־שום־סאָפֿעק
בלי־תּנאַי	בלי־טנײַ,בעלי־טנײַ
בלית־ברירה	בלעס־בריירע,בעלעס־בריירע
בלע״ז	בלאַז,בעלאַז
בלעם	בילעם
בלק	באָלעק
בלשון־אַתּה	בעלאָשן־אַטאָ
בלשון־חיבה	בעלאָשן־כיבע
בלשון־יחיד	בעלאָשן־יאָכעד
בלשון־סגי־נהור	בעלאָשן־סעגינאָער
בלשון־רבים	בעלאָשן־ראַבים
במדבר	באַמידבער
במה דבֿרים אַמורים	באַמע דוואָרים אַמורים
במהרה	בימהיירע
במהרה־בימינו	בימהיירע־בעיעמיינו
במזומן	בימזומען
במזומנים	בימזומאָנים
במזיד	בעמייזיד
במחילה	בימכילע
במחילה־גמורה	בימכילע־גמורע
במילא	בעמיילע
במינהג	בעמינעג
במיצוותיו	בעמיצווויסאָוו
במנוחה	בימנוכע
במסורה	בימסוירע
במציאות	בימציִעס
במקום שאין איש	בעמאָקעם שעיין איש
במקח	בעמעקעך
במקח־השווה	בעמעקעך־האַשאָווע
במשך	בעמעשעך
במתּנה	בעמאַטאָנע
בן	בען
בן־אָדם	בענאָדעם
בן־אַרבעים	בענאַרבאָיִם
בן־בית	בענבאַיִס
בן־ברית	בענבריס
בן־גיל	בענגיל
בן־דור	בענדאָר
בן־דעת	בענדאַאַס
בן־הנידה	בען־האַנידע
בן־הרבֿ	בענהאָראַוו
בן־זוג	בענזוג
בן־זכר	בענזאָכער
בן־זקונים	בענזקונים,בענסקונים
בן־טובֿים	בענטויווים
בן־יחיד	בעניאָכעד
בן־יקיר	בעניאַקער
בן־ישׂראל	בען־ייִסראָעל
בן־לילה	בינלײַלע
בן־מימון	בען־מײַמאָן
בן־מלך	בענמיילעך
בן־נבֿט	בען־נעוואָט
בן־נח	בען־נויעך
בן־סורר־ומורה	בען־סוירער־אומוירע
בן־סירא	בען־סירע
בן־עיר	בנעיִר,בעניר
בן־פּקועה	בענבעקוע,בענפּעקוע
בן־ציון	בענציִען
בן־קימא	בען־קאַיאָמע
בן־שיבֿעים	בענשיווים
בן־שישים	בענשישים
בן־שמונים	בענשמוינים
בן־תּורה	בענטוירע
בן־תּישעים	בענטישים
בנאמנות	בענעמאָנעס
בנאָק	בענאָק
בנוגע	בענעגייע
בנוהג־שבעולם	בענויעג־שעבאָוילעם
בנות־גיל	בנויס־גיל
בנות־זקונים	בנויס־זקונים,בנויס־סקונים
בנות־יעקבֿ	בנויס־יאַנקעוו
בנות־ישׂראל	בנויס־ייִסראָעל
בנות־ציון	בנויס־ציִען
בני־אָדם	בנייאָדעם,בנעיאָדעם
בני־אַרבעים	בנייאַרבאָיִם
בני־בית	בנייבאַיִס
בני־ברית	בנייבריס
בני־גיל	בנייגיל
בני־דור	בניידאָר
בני־דעת	בניידאַאַס
בני־הרבֿ	בנייהאָראַוו
בני־זוג	בנייזוג
בני־זקונים	בנייזקונים,בנייסקונים
בני־טובֿים	בנייטויווים
בני־יחידים	בניי־יעכידים
בני־ישׂראל	בניי־ייִסראָעל
בני־מלכים	בניי־מעלאָכים
בני־משה	בניי־מוישע
בני־נבֿיאים	בניי־נעוויִיִם
בני־נח	בניי־נויעך
בני־עניים	בניי־אַניִיִם
בני־קימא	בניי־קאַיאָמע
בני־רחמנים	בניי־ראַכמאָנים
בני־שיבֿעים	בניישיווים
בני־שישים	בניישישים
בני־שמונים	בניישמוינים
בני־תּורה	בנייטוירע
בני־תּישעים	בנייטישים
בניחותא	בעניכעסע
בנים	באָנים
בנים־זכרים	באָנים־זכאָרים,באָנים־סכאָרים
בנימוס	בענימעס
בנימין	בעניאָמען
בנימינס	בעניאָמענס
בנימינען	בעניאָמענען
בנימצא	בענימצע
בנין	ביניען
בנינים	ביניאָנים
בנעימות	בענימעס
בנעימותדיק	בענימעסדיק
בנעימותדיקן	בענימעסדיקן
בנעימותדיקע	בענימעסדיקע
בנעימותדיקער	בענימעסדיקער
בנערינו־ובֿזקנינו	בינאָריינו־אוּוויזקייניינו
בנקיטת־חפֿץ	בינקיטעס־כייפֿעץ
בנשימה־אַחת	בינשימע־אַכעס
בנשיקה	בינשיקע
בסבֿר־פּנים־יפֿות	בעסייווער־פּאָנעם־יאָפֿעס
בסוד	בעסאָד
בסוד־סודות	בעסאָד־סוידעס
בסיעתּא־דשמיא	בעסיִאַטע־דעשמײַע
בסך־הכּל	בעסעכאַקל
בסתר	בעסייסער
בעוונותינו־הרבים	באַוווינעסיינו־האָראַבים
בעזבושהניצע	בעזבושעניצע
בעזבושהניק	בעזבושעניק
בעזרת־השם	בעזרעס־האַשעם
בעזרת־השם־יתברך	בעזרעס־האַשעם־ייִסבאָרעך
בעיני ראָיתי	בעיינײַ ראָיִסי
בעיקר	בעיִקער
בעירום־ובֿחוסר־כּל	בעיירעם־אוּווכויסער־קאָל
בעל	באַאַל
בעל־	באַל
בעל־אַחריות	באַלאַכרײַעס
בעל־אַכסניא	באַלאַכסאַניע
בעל־בטוח	באַלבעטועך
בעל־בטחון	באַלביטאָכן
בעל־בכי	באַלבעכי
בעל־ברית	באַלבריס
בעל־בשׂר	באַלבאָסער
בעל־גאווה	באַלגײַווע
בעל־גאווהטע	באַלגײַוועטע
בעל־גאווהניצע	באַלגײַוועניצע
בעל־גאווהניק	באַלגײַוועניק
בעל־גוזמא	באַלגוזמע 
בעל־גוף	באַלגוף
בעל־דברן	באַלדאַברען
בעל־דברנים	באַל־דאַבראָנים
בעל־דבֿר	באַלדאָווער
בעל־דין	באַלדין
בעל־דיקדוק	באַלדיקדעק
בעל־דמיון	באַלדימיען
בעל־דמיונות	באַל־דימיוינעס
בעל־דעה	באַלדייע
בעל־דרך־ארץ	באַל־דערעכערעץ
בעל־דרשן	באַלדאַרשן
בעל־דרשנים	באַל־דאַרשאָנים
בעל־דרשער	באַלדאַרשער
בעל־הבית	באַלעבאָס
בעל־הביתטע	באַלעבאָסטע
בעל־הביתטעס	באַלעבאָסטעס
בעל־הביתל	באַלעבעסל
בעל־הבתּיש	באַלעבאַטיש
בעל־הבתּישן	באַלעבאַטישן
בעל־הבתּישע	באַלעבאַטישע
בעל־הבתּישער	באַלעבאַטישער
בעל־הבתּישקייט	באַלעבאַטישקייט
בעל־הבתּעווען	באַלעבאַטעווען
בעל־הגוף	באַלעגוף
בעל־הוצאה	באַלהויצאָע
בעל־הטורים	באַלהאַטורים
בעל־הכנסה	באַלהאַכנאָסע
בעל־הכנסת־אורחים	באַל־האַכנאָסעס־אָרכים
בעל־הלוואה	באַלהאַלוואָע
בעל־המצאה	באַלהאַמצאָע
בעל־הנס	באַל־האַנעס
בעל־העזה	באַלהאָזע
בעל־השפּעה	באַלהאַשפּאָע
בעל־זכּרון	באַלזיקאָרן
בעל־חובֿ	באַלכויוו
בעל־חי	באַלכײַ
בעל־חייבֿ	באַלכײַעוו
בעל־חלומות	באַלכאַלוימעס
בעל־חסד	באַלכעסעד
בעל־חשבון	באַלכעזשבם
בעל־חתונה	באַלכאַסענע
בעל־טאַקסע	באַלטאַקסע
בעל־טובֿה	באַלטויווע
בעל־טובֿהניצע	באַלטויוועניצע
בעל־טענה	באַלטײַנע
בעל־יובֿל	באַליויוול
בעל־יובֿלטע	באַליויוולטע
בעל־יועץ	באַליויעץ
בעל־יועצטע	באַליויעצטע
בעל־ייִאוש	באַלייִעש
בעל־ייִחוס	באַלייִכעס
בעל־ייִחוסטע	באַלייִכעסטע
בעל־יכולת	באַליעכוילעס
בעל־יסורים	באַליעסורים
בעל־כּוח	באַלקויעך
בעל־כּיס	באַלקיס
בעל־כּישרון	באַלקישרען
בעל־כּעסן	באַלקײַסן
בעל־כּעסנטע	באַלקײַסנטע
בעל־כּרחה	באַלקאָרכע
בעל־כּרחו	באַלקאָרכע
בעל־כּרחך	באַלקאָרכאָך,באַלקאָרכעכאָ
בעל־כּרחך אַתּה חי	באַלקאָרכעכאָ אַטאָ כײַ
בעל־לשון	באַל־לאָשן
בעל־לשון־קודש	באַל־לאָשנקוידעש
בעל־מגזם	באַלמעגאַזעם
בעל־מגזמטע	באַלמעגאַזעמטע
בעל־מגיה	באַלמאַגיִע
בעל־מדקדק	באַלמעדאַקדעק
בעל־מוח	באַלמויעך
בעל־מום	באַלמום 
בעל־מוסף	באַלמוסעף
בעל־מוסר	באַלמוסער
בעל־מופֿת	באַלמויפֿעס
בעל־מוצלח	באַלמוצלעך
בעל־מזג־טובֿ	באַלמעזעקטאָוו
בעל־מזל	באַלמאַזל
בעל־מחבר	באַלמעכאַבער
בעל־מחיה	באַלמיכיע
בעל־מחלוקת	באַלמאַכלויקעס
בעל־מחשבֿות	באַלמאַכשאָוועס
בעל־מטופּל	באַלמעטופּל
בעל־מטופּלים	באַל־מעטופּאָלים
בעל־מידה	באַלמידע
בעל־מידות	באַלמידעס
בעל־מיחוש	באַלמייכעש
בעל־מיצווה	באַלמיצווע
בעל־מישפּט	באַלמישפּעט
בעל־מכשף	באַלמעכאַשעף
בעל־מלאָכה	באַלמעלאָכע
בעל־מלאָכהס	באַלמעלאָכעס
בעל־מלאָכות	באַלמעלאָכעס
בעל־מלחמה	באַלמילכאָמע
בעל־מליצה	באַלמעליצע
בעל־מנגן	באַלמענאַגן
בעל־מפֿוניצע	באַלמעפֿוניצע
בעל־מפֿונק	באַלמעפֿונעק
בעל־מפֿטיר	באַלמאַפֿטער
בעל־מפֿרנס	באַלמעפֿאַרנעס
בעל־מציאות	באַלמעציִעס
בעל־מצליח	באַלמאַצליִעך
בעל־מקובל	באַלמעקובל
בעל־מקנא	באַלמעקאַנע
בעל־מרה־שחורה	באַל־מאָרעשכוירע
בעל־משחית	באַלמאַשכיס
בעל־משפּחה	באַלמישפּאָכע
בעל־נס	באַלנעס,באַל־נעס
בעל־נסיון	באַלניסויען
בעל־נעילה	באַלנילע
בעל־נצחון	באַלניצאָכן
בעל־סוד	באַלסאָד
בעל־עבֿירה	באַלאַוויירע
בעל־עבֿירהניצע	באַלאַוויירעניצע
בעל־עבֿירהניק	באַלאַוויירעניק
בעל־עבֿרי	באַליוורע
בעל־עגלה	באַלעגאָלע
בעל־עוולה	באַלאַוולע
בעל־עסק	באַלייסעק
בעל־עסקן	באַלאַסקן
בעל־עצה	באַלייצע
בעל־פּה	באַלפּע,בעאַלפּע
בעל־פּועל	באַלפּויעל
בעל־פּחדן	באַלפּאַכדן
בעל־פּליטה	באַלפּלייטע
בעל־פּקדון	באַלפּיקאָדן
בעל־פּרנסה	באַלפּאַרנאָסע
בעל־פּשרן	באַלפּאַשרען
בעל־צדקה	באַלצדאָקע
בעל־צדקהטע	באַלצדאָקעטע
בעל־צדקות	באַל־צדאָקעס
בעל־צורה	באַלצורע
בעל־צורות	באַל־צורעס
בעל־קבלה	באַלקאַבאָלע
בעל־קורא	באַלקוירע
בעל־קרי	באַלקיירע,באַלקערי
בעל־קריאה	באַלקריִע
בעל־רחמים	באַלראַכמים
בעל־רחמן	באַלראַכמען
בעל־רחמנות	באַלראַכמאָנעס
בעל־שחרית	באַלשאַכרעס
בעל־שם	באַלשעם
בעל־שם־טובֿ	באַלשעמטאָוו
בעל־שפֿע	באַלשעפֿע
בעל־שׂימחה	באַלסימכע
בעל־שׂימחהטע	באַלסימכעטע
בעל־שׂימחהניצע	באַלסימכעניצע
בעל־שׂכל	באַלסייכל
בעל־שׂכלטע	באַלסייכלטע
בעל־תּאווה	באַלטײַווע
בעל־תּאווהניצע	באַלטײַוועניצע
בעל־תּאווהניק	באַלטײַוועניק
בעל־תּבֿיעה	באַלטוויִע
בעל־תּוקע	באַלטעקייע
בעל־תּחבולה	באַלטאַכבולע
בעל־תּכלית	באַלטאַכלעס
בעל־תּכליתניצע	באַלטאַכלעסניצע
בעל־תּנך	באַלטענאַך
בעל־תּפֿילה	באַלטפֿילע
בעל־תּפֿילות	באַל־טפֿילעס
בעל־תּקיעה	באַלטקיִע
בעל־תּקיעות	באַל־טקיִעס
בעל־תּקיף	באַלטאַקעף
בעל־תּקיפֿים	באַל־טאַקיפֿים,באַל־טקיפֿים
בעל־תּשובֿה	באַלטשוּווע ,באַל־טשוּווע
בעל־תּשובֿהטע	באַלטשוּוועטע
בעל־תּשובֿהניצע	באַלטשוּוועניצע
בעל־תּשובֿהניק	באַלטשוּוועניק
בעל־תּשובֿות	באַל־טשוּוועס
בעלה	באַאַלע
בעלי	באַאַלי
בעלי־	באַלע
בעלי־אַחריות	באַלע־אַכרײַעס
בעלי־אַכסניות	באַלע־אַכסאַניעס
בעלי־בטוחים	באַלע־בעטוכים
בעלי־בטחון	באַלע־ביטאָכן
בעלי־בכי	באַלע־בעכי
בעלי־בריתן	באַלע־בריסן
בעלי־בשׂרס	באַלע־באָסערס
בעלי־בתּים	באַלעבאַטים
בעלי־גאוות	באַלע־גײַוועס
בעלי־גוזמא	באַלע־גוזמע
בעלי־גוזמאָות	באַלע־גוזמאָעס
בעלי־גוזמות	באַלע־גוזמעס
בעלי־גופֿים	באַלע־גופֿים
בעלי־דברנים	באַלע־דאַבראָנים
בעלי־דבֿר	באַלע־דאָווער
בעלי־דינים	באַלע־דינים
בעלי־דיקדוק	באַלע־דיקדעק
בעלי־דמיונות	באַלע־דימיוינעס
בעלי־דעות	באַלע־דייעס
בעלי־דרך־ארץ	באַלע־דערעכערעץ
בעלי־דרשנים	באַלע־דאַרשאָנים
בעלי־הוצאָות	באַלע־הויצאָעס
בעלי־הכנסה	באַלע־האַכנאָסע
בעלי־הכנסת־אורחים	באַלע־האַכנאָסעס־אָרכים
בעלי־הלוואָות	באַלע־האַלוואָעס
בעלי־המצאָות	באַלע־האַמצאָעס
בעלי־השפּעה	באַלע־האַשפּאָע
בעלי־זכּרון	באַלע־זיקאָרן
בעלי־חובֿות	באַלע־כויוועס
בעלי־חייבֿים	באַלע־כאַיאָווים
בעלי־חיים	באַלע־כאַיִם
בעלי־חלומות	באַלע־כאַלוימעס
בעלי־חסדים	באַלע־כסאָדים
בעלי־חשבונות	באַלע־כעזשבוינעס
בעלי־חתונה	באַלע־כאַסענע
בעלי־טאַקסעס	באַלע־טאַקסעס
בעלי־טובֿות	באַלע־טויוועס
בעלי־טענות	באַלע־טײַנעס
בעלי־יובֿלס	באַלע־יויוולס
בעלי־יועצם	באַלע־יויעצים
בעלי־ייִאוש	באַלע־ייִעש
בעלי־ייִחוס	באַלע־ייִכעס
בעלי־ייִחוסים	באַלע־ייִכוסים
בעלי־יכולת	באַלע־יעכוילעס
בעלי־יסורים	באַלע־יעסורים
בעלי־כּוח	באַלע־קויעך
בעלי־כּוחות	באַלע־קויכעס
בעלי־כּיסים	באַלע־קיסים
בעלי־כּישרונות	באַלע־קישרוינעס
בעלי־לשון־קודש	באַלע־לאָשנקוידעש
בעלי־לשונות	באַלע־לעשוינעס
בעלי־מדקדקים	באַלע־מעדאַקדעקים
בעלי־מוח	באַלע־מויעך
בעלי־מוחות	באַלע־מויכעס
בעלי־מום	באַלע־מום
בעלי־מומים	באַלע־מומים
בעלי־מוסף	באַלע־מוסעף
בעלי־מוסר	באַלע־מוסער
בעלי־מופֿתים	באַלע־מאָפֿסים
בעלי־מזג־טובֿ	באַלע־מעזעקטאָוו
בעלי־מזלות	באַלע־מאַזאָלעס
בעלי־מחברים	באַלע־מעכאַברים
בעלי־מחיות	באַלע־מיכיעס
בעלי־מחלוקת	באַלע־מאַכלויקעס
בעלי־מחלוקתן	באַלע־מאַכלויקעסן
בעלי־מחשבֿות	באַלע־מאַכשאָוועס
בעלי־מטופּלים	באַלע־מעטופּאָלים
בעלי־מידות	באַלע־מידעס
בעלי־מיחושים	באַלע־מייכושים
בעלי־מיחושן	באַלע־מייכעשן
בעלי־מיצוות	באַלע־מיצוועס
בעלי־מישפּט	באַלע־מישפּעט
בעלי־מכשפֿים	באַלע־מעכאַשפֿים
בעלי־מלאָכות	באַלע־מעלאָכעס
בעלי־מלחמות	באַלע־מילכאָמעס
בעלי־מליצות	באַלע־מעליצעס
בעלי־מנגנים	באַלע־מענאַגנים
בעלי־מפֿטיר	באַלע־מאַפֿטער
בעלי־מפֿרנסים	באַלע־מעפֿאַרנעסים
בעלי־מציאות	באַלע־מעציִעס
בעלי־מצליחים	באַלע־מאַצליכים
בעלי־מקובלים	באַלע־מעקובאָלים
בעלי־מקנאים	באַלע־מעקאַנים
בעלי־מרה־שחורה	באַלע־מאָרעשכוירע
בעלי־משחיתים	באַלע־מאַשכיסים
בעלי־משפּחות	באַלע־מישפּאָכעס
בעלי־נסיונות	באַלע־ניסיוינעס
בעלי־נסים	באַלע־ניסים
בעלי־נעילה	באַלע־נילע
בעלי־נצחונות	באַלע־ניצכוינעס
בעלי־סודות	באַלע־סוידעס
בעלי־עבֿירות	באַלע־אַוויירעס
בעלי־עבֿרי	באַלע־איוורע
בעלי־עוולות	באַלע־אַוולעס
בעלי־עסקים	באַלע־אַסאָקים
בעלי־עסקנים	באַלע־אַסקאָנים
בעלי־עצות	באַלע־אייצעס
בעלי־פּועלים	באַלע־פּויאַלים
בעלי־פּחדנים	באַלע־פּאַכדאָנים
בעלי־פּליטות	באַלע־פּלייטעס
בעלי־פּקדונות	באַלע־פּיקדוינעס
בעלי־פּרנסה	באַלע־פּאַרנאָסע
בעלי־פּשרנים	באַלע־פּאַשראָנים
בעלי־צדקה	באַלע־צדאָקע
בעלי־צדקות	באַלע־צדאָקעס
בעלי־צורות	באַלע־צורעס
בעלי־קבלה	באַלע־קאַבאָלע
בעלי־קרי	באַלע־קיירע
בעלי־קריאה	באַלע־קריִע
בעלי־רחמים	באַלע־ראַכמים
בעלי־רחמנות	באַלע־ראַכמאָנעס
בעלי־רחמנים	באַלע־ראַכמאָנים
בעלי־שחרית	באַלע־שאַכרעס
בעלי־שחריתים	באַלע־שאַכרייסים
בעלי־שם	באַלע־שעם
בעלי־שמות	באַלע־שיימעס
בעלי־שפֿע	באַלע־שעפֿע
בעלי־שׂימחות	באַלע־סימכעס
בעלי־שׂכל	באַלע־סייכל
בעלי־תּאוות	באַלע־טײַוועס
בעלי־תּבֿיעות	באַלע־טוויִעס
בעלי־תּוספֿות	באַלע־טויסעפֿעס
בעלי־תּחבולות	באַלע־טאַכבולעס
בעלי־תּכלית	באַלע־טאַכלעס
בעלי־תּכליתים	באַלע־טאַכלייסים
בעלי־תּנך	באַלע־טענאַך
בעלי־תּפֿילות	באַלע־טפֿילעס
בעלי־תּקיעות	באַלע־טקיִעס
בעלי־תּקיפֿים	באַלע־טאַקיפֿים,באַלע־טקיפֿים
בעלי־תּשובֿה	באַלע־טשוּווע
בעלי־תּשובֿות	באַלע־טשוּוועס
בעלמא	בעאַלמע
בעלמא דקשוט	בעאַלמע דיקשויט
בעלן	באַלן
בעלנות	באַלאָנעס
בעלנטע	באַלנטע
בעלנים	באַלאָנים
בעמידה	באַאַמידע
בעצם	בעעצעם
בערך	בעערעך
בעש״ט	בעשט
בעתּו	בעיִטע
בעת	בייס
בעת־מעשׂה	בייס־מײַסע
בפּה־אחד	בעפּע־עכעד
בפּה־מלא	בעפּע־מאָלע
בפּועל	בעפּויעל
בפּועל־ממש	בעפּויעל־מאַמעש
בפּחי־נפֿש	בעפּאַכיי־נעפֿעש
בפּישוט־ידים־ורגלים	בעפּישעט־יאָדאַיִם־וועראַגלאַיִם
בפּשטות	בעפּאַשטעס
בפֿומבי	בעפֿומבי
בפֿירוש	בעפֿיירעש
בפֿירוש הותּנה	בעפֿיירעש הוטנע
בפֿירושן	בעפֿיירעשן
בפֿירושע	בעפֿיירעשע
בפֿירושער	בעפֿיירעשער
בפֿני־כּל־עם־ועדה	ביפֿניי־קאָל־אַם־וועיידע
בפֿני־עם־ועדה	ביפֿניי־אַם־וועיידע
בפֿני־קהל־ועדה	ביפֿניי־קאָאָל־וועיידע
בפֿרהסיא	בעפֿערעסיע
בפֿרוטרוט	ביפֿרויטרעט
בפֿרט	ביפֿראַט
בפֿרטיות	ביפֿראָטיעס
בצוואה	בעצאַוואָע
בצורת־	בעצורעס
בצורת־אָדם	בעצורעס־אָדעם
בציבור	בעציבער
בצימצום	בעצימצעם
בצלאל	בעצאַלעל
בצלאלן	בעצאַלעלן
בצלאלס	בעצאַלעלס
בקבלה	בעקאַבאָלע
בקבֿיעות	ביקוויִעס
בקהילה־קדושה	בעקעהילע־קדוישע
בקוו־הבריאה	בעקאַוו־האַבריִע
בקוו־הבריאות	בעקאַוו־האַבריִעס
בקוו־החיים־והשלום	בעקאַוו־האַכאַיִם־וועהאַשאָלעם
בקול־רם	בעקאָל־ראָם
בקולי־קולות	בעקאָלע־קוילעס,בעקאָל־קוילעס
בקי	באָקע
בקי בכל־חדרי־תּורה	באָקע בעכאָל־כעדרע־טוירע,בעכאָל־כעדרע־טוירע
בקי בשבֿע־חכמות	באָקע בעשעווע־כאָכמעס,בעשעווע־כאָכמעס
בקיאה	בעקיִע
בקיאות	בעקיִעס
בקיים	בעקיִיִם
בקיצור	בעקיצער
בק״ק	בעקאַק
בקרובֿ	בעקאָרעוו
בקשה	באַקאָשע
בקשר	בעקעשער
בר־אורין	באַרוריען
בר־בי־רבֿ	באַרבעראַוו
בר־דעת	באַרדאַאַס
בר־כּוזבא	באַר־קוזבע
בר־כּוכבא	באַר־קאָכבע
בר־מזל	באַרמאַזל
בר־מינן	באַרמינאַן,באַרמענען
בר־מיצווה	באַרמיצווע
בר־מיצווה־בחור	באַרמיצווע־באָכער
בר־מיצוות	באַרמיצוועס
בר־נש	באַרנאַש
בר־סמכא	באַרסאַמכע
בר־עונשין	באַראָנשין
בר־פּלוגתּא	באַרפּלוקטע
בר־שׂכל	באַרסייכל
בראָש	בעראָש
בראשו־ורובו	בערוישע־ווערובע
בראשית	בריישעס
ברבים	בעראַבים
ברד	באָראָד
ברואים	ברויִם
ברובֿ־עם	בעראָוו־אַם
ברוגז	ברויגעז
ברוגז־טאַנץ	ברויגעז־טאַנץ
ברוגזן	ברויגעזן
ברווח	בערעוועך
ברוח־הקודש	בערועך־האַקוידעש
ברוך	באָרעך
ברוך דיין אמת	באָרעך דײַען עמעס
ברוך דיין האמת	באָרעך דײַען האָעמעס
ברוך השם יום יום	באָרעך האַשעם יוים יוים
ברוך שפּטרני	באָרעך שעפּאָטראַני
ברוך־אַתּה	באָרעך־אַטאָ,באָרעך־אַטע
ברוך־הבא	באָרכאַבע,באָרעכאַבאָ,באָרעכאַבע
ברוך־הוא	באָרכו,באָרעך־הו
ברוך־הנימצא	באָרעך־האַנימצע
ברוך־השם	באָרכאַשעם,באָרעכאַשעם
ברוכים־הבאָים	ברוכים־האַבאָיִם
ברוכים־היושבֿים	ברוכים־האַיוישווים
ברוכן	באָרעכן
ברוכס	באָרעכס
ברומו־של־עולם	בערומע־שעל־אוילעם
ברור	באָרער
ברור־כּשמש	באָרער־קאַשעמעש
ברוריה	ברוריע
ברחבֿותדיק	בעראַכוועסדיק
ברחל בתּך הנאַקעטע	בעראָכל ביטכאָ האַנאַקעטע
ברחל בתּך הקטנה	בעראָכל ביטכאָ האַקטאַנאָ
ברחען	באַרכען
ברחענען	באַרכענען
ברי	באָרע
ברי־לי	באָרע־לי
בריאה	בריִע
בריאות	בריִעס
בריאות־הגוף	בריִעס־האַגוף
בריאת־העולם	בריִעס־האָוילעם
בריאת־עולם	בריִעס־אוילעם
בריה	בעריע
בריה־נפֿלאה	בעריע־ניפֿלאָע
בריהן	בעריען
בריהש	בעריעש
בריהשאַפֿט	בעריעשאַפֿט
בריהשן	בעריעשן
בריהשע	בעריעשע
בריהשער	בעריעשער
בריהשקייט	בעריעשקייט
ברײַתא	ברײַסע
ברירה	בריירע
בריש־גלי	בערייש־געליי
בריתּ יוסף תּרומפּלדור	בריט יאָסעף טרומפּעלדאָר
ברית	בריס
ברית־חדשה	בריס־כאַדאָשע
ברית־מילה	בריסמילע
ברכּת־המזון	בירקעס־האַמאָזן
ברכּת־כּהנים	בירקעס־קעהאַנים
ברכה	בראָכע
ברכה־לבֿטלה	בראָכע־לעוואַטאָלע
ברכהן	בראָכען
ברכהס	בראָכעס
ברכו	באָרכו
ברכות	בראָכעס
ברכי נפֿשי	באָרכי נאַפֿשי
ברכיה	בראַכיע
ברמז	בערעמעז
ברמיזה	בירמיזע
ברצון	בעראָצן
ברשות־	בירשוס
בשגגה	בישגאָגע
בשוגג	בעשויגעג
בשום־אופֿן	בעשום־אויפֿן
בשום־ענין־ואופֿן	בעשום־איניען־וועויפֿן
בשותּפֿות	בעשוטפֿעס
בשײַכות	בעשײַכעס
בשכנות	בישכיינעס
בשלום	בעשאָלעם
בשלום־ושלווה	בעשאָלעם־וועשאַלווע
בשלח	בעשאַלאַך
בשלמות	בישליימעס
בשם־אומרו	בעשעם־אָמרוי
בשם־ומלכות	בעשעם־אומאַלכעס,בעשעם־וועמאַלכעס
בשן	באָשן
בשן־ועין	בעשיין־וואָאַיִן
בשעתּה	בעשאַטע
בשעתּו	בעשאַטע
בשעתּם	בעשאַטעם
בשעת	בעשאַס
בשעת־הדחק	בעשאַס־האַטכאַק
בשעת־מעשׂה	בעשאַס־מײַסע
בשעתן	בעשאַסן
בשפֿע	בעשעפֿע
בשתּיקה	בישטיקע
בשׂורה	פּסורע
בשׂורה־טובֿה	בסורע־טויווע,פּסורע־טויווע
בשׂורה־רעה	בסורע־ראָע,פּסורע־ראָע
בשׂורות	פּסורעס
בשׂורות־טובֿות	פּסורעס־טויוועס
בשׂורות־רעות	פּסורעס־ראָעס
בשׂמים	בסאָמים,פּסאָמים
בשׂמים־ביקס	בסאָמים־ביקס,פּסאָמים־ביקס
בשׂר	באָסער
בשׂר כּשר	באָסער קאָשער
בשׂר־ודגים	באָסער־וועדאָגים
בשׂר־ודם	באָסערוועדאָם
בתּוך	בעטאָך
בתּופּים־ובֿמחולות	בעטופּים־אוּווימכוילעס
בתּורת	בעטוירעס
בתּי־	באָטע
בתּי־הכּנסת	באָטע־קנעסעס
בתּי־יתומים	באָטע־יעסוימים
בתּי־מדרשים	באָטע־מידראָשים
בתּים	באַטים
בתּכלית־ה…	בעטאַכלעס־האַ
בתּכלית־הפּשטות	בעטאַכלעס־האַפּאַשטעס
בתּכלית־השׂינאה	בעטאַכלעס־האַסינע
בתּמיה	ביטמיִע
בתּמימות	ביטמימעס
בתּנאַי	ביטנײַ
בתּשואות־חן	ביטשועס־כיין
בת־	באַס
בת־גיל	באַס־גיל
בת־היענה	באַס־האַיײַנע
בת־הרבֿ	באַס־האָראַוו
בת־השמים	באַס־האַשאָמאַיִם
בת־זקונים	באַס־זקונים,באַס־סקונים
בת־טובֿים	באַס־טויווים
בת־יחידה	באַס־יעכידע
בת־יחידקע	באַס־יעכיטקע
בת־יענה	באַס־יײַנע
בת־ישׂראל	באַס־ייִסראָעל
בת־כּהן	באַס־קויען
בת־מלכּה	באַסמאַלקע
בת־נעמה	באַס־נײַמע
בת־ציון	באַס־ציִען
בת־שבֿע	באַסשעווע
בת־שיבֿעים	באַס־שיווים
בת־שמונים	באַס־שמוינים
בת־תּישעים	באַס־טישים
בתוך	בעסאָך
בתוכם	בעסויכעם
בתולה	פּסולע
בתולות	פּסולעס
בתולים	פּסולים
בתיה	באַסיע
בתיהן	באַסיען
בתיהס	באַסיעס
בֿית	ווייס
ג	גימל
גאווה	גײַווע
גאוותן	גײַווסן,גײַפֿסן
גאוותנים	גײַווסאָנים,גײַפֿסאָנים
גאולה	געולע
גאָון	גאָען
גאונות	געוינעס
גאוני־הדור	געויניי־האַדאָר
גאונים	געוינים
גאוניש	געויניש
גאות	גייעס
גבאָות	גאַבאָעס
גבאי	גאַבע
גבאיטע	גאַבעטע
גבאיטעס	גאַבעטעס
גבאָים	גאַבאָיִם
גבאיס	גאַבעס
גבֿול	גוווּל
גבֿורה	גוווּרע
גבֿיר	גוויר,געוויר
גבֿירטע	גווירטע,געווירטע
גבֿירינטע	גווירנטע,געווירנטע
גבֿיריש	גוויריש,געוויריש
גבֿית־עדות	גוויִעס־איידעס
גבֿר	גוואַר
גבֿר־אַלים	גוואַר־אַלים
גבֿר־חלש	גוואַר־כאַלעש
גבֿרות	גאַוורעס
גבֿריאל	גאַווריִעל
גבֿריאלן	גאַווריִעלן
גבֿריאלס	גאַווריִעלס
גבֿרן	גאַוורען
גבֿרנים	גאַווראָנים
גד	גאָד
גדול	גאָדל
גדול־בישׂראל	גאָדל־בעיִסראָעל
גדול־הדור	גאָדל־האַדאָר
גדולדיק	גאָדלדיק
גדולה	גדוילע,געדולע
גדולי־הדור	גדוילע־האַדאָר
גדולים	גדוילים
גדולים־בישׂראל	גדוילים־בעיִסראָעל
גדי	געדי
גדלות	גאַדלעס
גדליה	געדאַליע
גדליהו	געדאַליאָהו
גדליהוס	געדאַליאָהוס
גדליהן	געדאַליען
גדליהס	געדאַליעס
גדלן	גאַדלען
גדלנות	גאַדלאָנעס
גדלנטע	גאַדלענטע
גדלנים	גאַדלאָנים
גדלע	גאָדלע
גדר	געדער
גדרים	גדאָרים
גואל	גויעל
גואל־צדק	גויעל־צעדעק
גואלים	גאָיאַלים,גויעלים
גובֿר	גויווער
גוג־ומגוג	גאָג־אומאָגעג
גוג־מגוג	גאָגמעגאָג
גוזמא	גוזמע
גוזמאדיק	גוזמעדיק
גוזמאָות	גוזמאָעס
גוזר	גויזער
גוזר־תּענית	גויזער־טאָנעס
גוי	גוי
גוי־גמור	גוי־גאָמער
גויה	גויע
גויים	גאָיִם,גוייִם
גויים־גמורים	גאָיִם־גמורים
גוייִש	גאָיִש
גולה	גוילע
גולי־	גוילע
גולי־ספֿרד	גוילע־ספֿאַרד
גולים	גוילים
גולם	גוילעם
גולמים	גוילאָמים
גולמס	גוילעמס
גומל	גוימל
גונז	גוינעז
גוסס	גויסעס
גוססן	גויסעסן
גוסען	גויסען
גוסענען	גויסענען
גוף	גוף
גוף־המעשׂה	גוף־האַמײַסע
גופֿא	גופֿע
גורל	גוירל
גורלדיק	גוירלדיק
גורלות	גויראָלעס
גורם	גוירעם,גוירעם
גורמים	גאָרמים
גורס	גוירעס
גושן	גוישן
גזירה	גזיירע
גזירה־שווה	גזיירע־שאָווע
גזירות	גזיירעס
גזירת־תּ״ח	גזיירעס־טאַך
גזירת־תּ״ח ותּ״ט	גזיירעס־טאַך וועטאַט
גזלה	גזיילע
גזלות	גזיילעס
גזלן	גאַזלען
גזלנו	גאָזאַלנו
גזלנות	גאַזלאָנעס
גזלנטע	גאַזלענטע
גזלנים	גאַזלאָנים
גזלניש	גאַזלאָניש
גזלעווויסטווע	גאַזלעווויסטווע
גזלעווויע	גאַזלעווויע
גזלען	גאַזלען
גזלענען	גאַזלענען
גזע	געזע
גזר	גזאַר
גזר־דין	גזאַרדין
גט	געט
גטן	געטן
גיבור	גיבער
גיבורים	גיבוירים
גיבוריש	גיבויריש,גיבעריש
גידול־בנים	גידל־באָנים
גידוף	גידעף
גידופֿים	גידופֿים
גידין	גידן
גיהנום	געהענעם,גענעם
גיור	גיִער
גיורים	גיִורים
גיות	גײַעס
גיטין	גיטין,געטן
גילגול	גילגל
גילגול־הנפֿש	גילגל־האַנעפֿעש
גילגול־מחילות	גילגל־מעכילעס
גילגול־שלג	גילגל־שעלעג
גילגולים	גילגולים
גילוי	גילע
גילוי־אליהו	גילע־עליאָהו
גילוי־עריות	גילע־אַרויעס,גילע־אַרײַעס
גילוי־שכינה	גילע־שכינע
גילויים	גילויִם
גימטריא	גימאַטריע
גימל	גימל
גירוש	גיירעש
גירושים	גיירושים
גירסא	גירסע
גירסא־דינקותא	גירסע־דעיאַנקעסע
גירסאָות	גירסאָעס
גל־עד	גאַל־עד
גל־של־עצמות	גאַל־שעל־אַצאָמעס
גלגל	גאַלגל
גלגל החוזר	גאַלגל האַכויזער
גלגל החוזר בעולם	גאַלגל האַכויזער באָוילעם
גלגל חוזר	גאַלגל כויזער
גלגל חוזר בעולם	גאַלגל כויזער באָוילעם
גלגלים	גאַלגאַלים
גלוח	געלועך
גלוחים	גלוכים
גלות	גאָלעס
גלות־	גאָלעס
גלות־בבֿל	גאָלעס־באָוול
גלות־השכינה	גאָלעס־האַשכינע
גלות־מצרים	גאָלעס־מיצראַיִם
גלח	גאַלעך
גלחות	גאַלכעס
גלחים	גאַלאָכים
גלחס	גאַלעכס
גליון	גילויען,גיליען
גליונות	גיליוינעס
גלילה	גלילע
גלית	גאָליעס
גם	גאַם
גם זו לטובֿה	גאַמזו לעטויווע
גם־אַתּם	גאַם־אַטעם
גמור	גאָמער
גמורה	גמורע
גמורים	גמורים
גמילות־חסד	גמילעס־כעסעד
גמילות־חסדים	גמילעס־כאַסאָדים,גמילעס־כסאָדים
גמר	גמאַר
גמר חתימה טובֿה	גמאַר כסימע טויווע
גמר טובֿ	גמאַר טאָוו
גמרא	געמאָרע
גמרות	געמאָרעס
גן־עדן	גאַניידן,געניידעם
גן־עדן־התּחתּון	גאַניידן־האַטאַכטן
גן־עדן־תּחתּון	גאַניידן־טאַכטן
גנאַי	גנײַ
גנבֿ	גאַנעוו
גנבֿה	גאַנייווע,גנייווע,גענייווע
גנבֿהש	גאַנייוויש,גנייוויש,גענייוויש
גנבֿהשן	גאַנייווישן
גנבֿהשע	גאַנייווישע
גנבֿהשער	גאַנייווישער
גנבֿות	גנייוועס
גנבֿטע	גאַנעווטע
גנבֿים	גאַנאָווים
גנבֿיש	גאַנייוויש,גנייוויש,גענייוויש
גנבֿישן	גאַנייווישן
גנבֿישע	גאַנייווישע
גנבֿישער	גאַנייווישער
גנבֿע	גאַנווע
גנבֿעט	גאַנוועט
גנבֿענען	גאַנווענען
גנבֿעסט	גאַנוועסט
גנבֿעסטו	גאַנוועסטו
גניזה	גניזע
גסיסה	גסיסע,קסיסע
געאַווירט	געאַווערט
געאַכלט	געאַכלט
געבריהט	געבעריעט
געגט	געגעט
געגטן	געגעטן
געגטנס	געגעטנס
געגטע	געגעטע
געגטער	געגעטער
געגנבֿעט	געגאַנוועט
געהרגעט	געהאַרגעט
געהרגעטן	געהאַרגעטן
געהרגעטנס	געהאַרגעטנס
געהרגעטע	געהאַרגעטע
געהרגעטער	געהאַרגעטער
געחבֿרט	געכאַווערט
געחזרט	געכאַזערט
געחידושט	געכידעשט
געחלומט	געכאָלעמט
געחלשט	געכאַלעשט
געחתמעט	געכאַסמעט
געטענהט	געטײַנעט
געיכולט	געיאָכלט
געיכלט	געיאָכלט
געירשנט	געיאַרשענט
געכּפֿלט	געקייפֿלט
געכּשרט	געקאַשערט
געכּתבֿעט	געקאַסוועט
געמוסרט	געמוסערט
געמישפּט	געמישפּעט
געמסרט	געמאַסערט
געמפּלט	געמאַפּלט
געסודעט	געסוידעט
געסמט	געסאַמט
געסרחה	געסראָכע
געעדותט	געיידעסט,געאיידעסט
געעצהט	געייצעט
געפּגרט	געפּייגערט
געפּועלט	געפּויעלט
געפּטרט	געפּאַטערט
געפּטרטן	געפּאַטערטן
געפּטרטע	געפּאַטערטע
געפּטרטער	געפּאַטערטער
געפּסלט	געפּאַסלט
געפּסקנט	געפּאַסקנט
גערודפֿט	גערוידעפֿט
גערעשט	געראַשט
געשחטן	געשאָכטן
געשיכּורט	געשיקערט
געשמדט	געשמאַט
גר	גער
גר־צדק	גער־צעדעק
גרגרת	גאַרגערעס
גרוגרת־דרבי־צדוק	גרויגרעס־דעראַבי־צאָדעק
גרונם	גרוינעם
גרוש	גאָרעש,גיירעש
גרושה	גרושע
גרושים	גרושים
גרטע	גערטע
גרים	גיירים
גרשון	גערשן
גרשונס	גערשנס
גרשם	גערשן
גרשמס	גערשנס
גשם	געשעם
גשמיות	גאַשמיִעס
גשמיותדיק	גאַשמיִעסדיק
גשמים	גשאָמים,קשאָמים
ד	דאַלעט
ד…	דע…
ד׳	האַשעם
דאגה	דײַגע
דאגהן	דײַגען
דאגהנען	דײַגענען
דאגת־הכּלל	דײַגעס־האַקלאַל
דאגת־פּרנסה	דײַגעס־פּאַרנאָסע
דאורײַתא	דעוירײַסע
דאָס חיות	דאָס כיִעס
דבר	דאַבער
דברט	דאַבערט
דברן	דאַבערן,דאַברען
דברנים	דאַבראָנים
דברסט	דאַבערסט
דברסטו	דאַבערסטו
דבֿורה	דוווירע
דבֿורה הנבֿיאה	דוווירע האַנעוויִע
דבֿורהלע	דוווירעלע
דבֿורהלען	דוווירעלען
דבֿורהלעס	דוווירעלעס
דבֿורהן	דוווירען
דבֿורהס	דוווירעס
דבֿקות	דווייקעס
דבֿקען	דווייקען
דבֿקענען	דווייקענען
דבֿר	דעווער
דבֿר־אַחר	דאָוועראַכער
דבֿר־גדול	דאָווער־גאָדל
דבֿר־חול	דוואַרכאָל
דבֿר־חכמה	דוואַרכאָכמע
דבֿר־מלכות	דוואַר־מאַלכעס
דבֿר־צדקה	דוואַרצדאָקע
דבֿר־שבקדושה	דאָווער־שעביקדושע
דבֿר־שקר	דוואַרשעקער
דבֿר־תּורה	דוואַרטוירע
דבֿרי־אלוקים־חיים	דיוורע־עלויקים־כאַיִם
דבֿרי־הימים	דיוורע־האַיאָמים
דבֿרי־חול	דיוורעכאָל
דבֿרי־חכמה	דיוורע־כאָכמע
דבֿרי־מלכות	דיוורע־מאַלכעס
דבֿרי־צדקה	דיוורע־צדאָקע
דבֿרי־שקר	דיוורע־שעקער
דבֿרי־תּורה	דיוורע־טוירע
דבֿרים	דוואָרים
דבֿרים בגוו	דוואָרים בעגייוו
דבֿרים העומדים ברומו־של־עולם	דוואָרים האָאָמדים בערומע־שעלוילעם
דבֿרים־בטלים	דוואָרים־בטיילים,דוואָרים־בעטיילים
דבֿרים־גדולים	דוואָרים־גדוילים
דבֿרים־כּהוויותן	דוואָרים־קעהאַוואָיאָסן
דבֿרים־כּהיותן	דוואָרים־קעיויסן
דבֿרים־שבקדושה	דוואָרים־שעביקדושע
דגוש	דאָגעש
דגושים	דגושים
דגים	דאָגים
דגל	דעגל
דגלים	דגאָלים
דגש	דאָגעש
דגשים	דגיישים
דהײַנו	דעהײַנע
דובֿ	דאָוו,דויוו
דובֿר־שקרים	דויווער־שקאָרים
דוגמא	דוגמע
דוגמאָות	דוגמאָעס
דוד	דאָוויד
דוד המלך	דאָוויד האַמיילעך
דוד המלכס	דאָוויד האַמיילעכס
דודל	דאָווידל
דודלס	דאָווידלס
דודלען	דאָווידלען
דודן	דאָווידן
דודס	דאָווידס
דווקא	דאַווקע,דאַפֿקע
דוחה	דויכע
דוחה־שבת	דויכע־שאַבעס
דוחק	דויכעק
דוכּוס	דוקעס
דוכּוסים	דוקסים,דוקעסים
דוכן	דוכן
דוכנען	דוכענען
דומם	דוימעם
דופֿק	דויפֿעק
דור	דאָר
דור־דורות	דאָר־דוירעס
דור־המבול	דאָר־האַמאַבל
דור־המידבר	דאָר־האַמידבער
דור־הפֿלגה	דאָר־האַפֿלאָגע
דורות	דוירעס
דורס	דוירעס
דחק	דכאַק,טכאַק
דחקות	דאַכקעס
די־והותר	דײַ־וועהויסער
די־ליאון	דע־לעאָן
דיבוק	דיבעק
דיבוקים	דיבוקים
דיבור	דיבער
דיבורים	דיבורים
דיין	דײַען
דיינו	דאַייינו
דיינות	דאַיאָנעס
דיינים	דאַיאָנים
דייקא	דייקע,דײַקע
דין	דין
דין־וחשבון	דין־וועכעזשבם
דין־תּורה	דינטוירע
דינא־דמלכותא	דינע־דעמאַלכעסע
דינה	דינע
דיני־כּשרות	דינע־קאַשרעס
דיני־ממונות	דינע־מאָמענעס
דיני־נפֿשות	דינע־נעפֿאָשעס
דיצה	דיצע
דיקדוק	דיקדעק
דיקדוקי־עניות	דיקדוקע־אַניִעס
דיקדוקים	דיקדוקים
דירה	דירע
דירות	דירעס
דלות	דאַלעס
דלותים	דאַלייסים
דלי	דעלי
דלילה	דלילע
דלמטה	דילמאַטע
דלמעלה	דילמײַלע
דלפֿון	דאַלפֿן
דלפֿונים	דאַלפֿאָנים
דלתּ	דאַלעט
דלתּ אַמות	דאַלעט אַמעס
דלתּ על דלתּ	דאַלעט אַל דאַלעט
דם	דאָם,דאַם
דם־נידה	דאַם־נידע
דם־שׂונא	דאַמסוינע
דם־שׂונאים	דאַמסאָנים
דמאי	דמײַ
דמיון	דימיען
דמיונות	דימיוינעס
דמים	דאָמים
דמשׂק	דאַמעסעק
דן	דאָן,דאַן
דניאל	דאַניִעל
דניאלן	דאַניִעלן
דניאלס	דאַניִעלס
דעה	דייע
דערהרגע	דערהאַרגע
דערהרגעט	דערהאַרגעט
דערהרגען	דערהאַרגען
דערהרגענען	דערהאַרגענען
דערהרגעסט	דערהאַרגעסט
דערהרגעסטו	דערהאַרגעסטו
דערכּעסן	דערקאַאַסן
דערעיקר	דעריקער
דערעיקרשט	דעריקערשט
דעררגזען	דערראַגזען
דעררגזענען	דערראַגזענען
דעת	דאַאַס
דעת־הקהל	דאַאַס־האַקאָאָל
דפּים	דאַפּים
דף	דאַף
דפֿק	דייפֿעק
דצ״ך	דעצאַך
דצ״ך עד״ש באח״ב	דעצאַך אַדאַש בעאַכאַב
דקה	דאַקע
דקה־מן־הדקה	דאַקע־מין־האַדאַקע
דקהילה־קדושה	דעקעהילע־קדוישע
דק״ק	דעקאַק
דרדקי	דאַרדעקע
דרדקי־מלמד	דאַרדעקע־מעלאַמעד
דרדקי־מלמדים	דאַרדעקע־מעלאַמדים
דרום	דאָרעם
דרוש	דרוש
דריסת־הרגל	דריסעס־האָרעגל
דרכּי־שלום	דאַרקע־שאָלעם
דרך	דערעך
דרך־אַגבֿ	דערעך־אַגעוו
דרך־ארץ	דערעכערעץ
דרך־ארצדיק	דערעכערעצדיק
דרך־ארצדיקן	דערעכערעצדיקן
דרך־ארצדיקס	דערעכערעצדיקס
דרך־ארצדיקע	דערעכערעצדיקע
דרך־ארצדיקער	דערעכערעצדיקער
דרך־הטבֿע	דערעך־האַטעווע
דרך־הישר	דערעך־האַיאָשער
דרך־המלך	דערעך־האַמיילעך
דרך־העולם	דערעך־האָוילעם
דרך־השלום	דערעך־האַשאָלעם
דרך־השׂכל	דערעך־האַסייכל
דרך־מלך	דערעך־מיילעך
דרך־עולם	דערעך־אוילעם
דרך־שלום	דערעך־שאָלעם
דרכים	דראָכים
דרש	דראַש
דרשה	דראָשע
דרשה־געשאַנק	דראָשע־געשאַנק
דרשות	דראָשעס
דרשן	דאַרשן
דרשנים	דאַרשאָנים
דרשען	דאַרשען
דרשענען	דאַרשענען
דשאָים־ועשׂבֿים	דשאָיִם־וואַסאָווים,טשאָיִם־וואַסאָווים
דת	דאַס
ה׳	אַדוישעם,האַשעם
ה…	האַ…
ה	היי
הא	היי
הא־הידיעה	היי־האַיעדיִע
האזינו	האַאַזינו
האַרמי	האָאַראַמי
הבֿדל	העוודל
הבֿדלה	האַוודאָלע
הבֿדלים	העוודיילים
הבֿטחה	האַפֿטאָכע
הבֿל	העוול
הבֿל־הבֿלים	האַווייל־האַוואָלים,העוול־האַוואָלים
הבֿל־הבֿלימדיק	העוול־האַוואָלימדיק
הבֿלים	האַוואָלים
הבֿנה	האַוואָנע
הבֿרה	האַוואָרע
הבֿרה־אַשכּנזית	האַוואָרע־אַשקענאַזיס
הגבה	האַגבע
הגבהה	האַגבאָע
הגדה	האַגאָדע
הגדה־של־פּסח	האַגאָדע־שעל־פּייסעך
הגדול הגיבור והנורא	האַגאָדל האַגיבער וועהאַנוירע
הגהה	האַגאָע
הגון	האָגן
הגונה	האַגונע
הגונים	האַגונים
הגם	האַגאַם
הדגשה	האַדגאָשע
הדיוט	העדיעט
הדיוט קופֿץ בראָש	העדיעט קויפֿעץ בעראָש
הדיוטים	העדיויטים
הדס	האָדעס
הדסה	האַדאַסע
הדסים	האַדאַסים
הדסל	האָדעסל
הדר	האָדער
הדרגה	האַדראָגע
הדרכה	האַדראָכע
הדרן	האַדרען
הדרת־פּנים	האַדרעס־פּאָנעם
הדרת־פּנימער	האַדרעס־פּענעמער
הוא הדין	הו האַדין
הוד	הויד
הוד־מלכות	האָד־מאַלכעס
הוד־מלכותו	האָד־מאַלכוסע
הודאה	הוידאָע
הודו	הוידע
הודעה	הוידאָע
הווה	הויווע
הוויה	האַווײַע
הוויות־העולם	האַווויעס־האָוילעם
הוויות־עולם	האַווויעס־אוילעם
הולך	הוילעך
הולך־רכיל	הוילעך־ראָכיל,הוילעך־ראָכל
הולכן	הוילעכן
הון־רבֿ	הוין־ראַוו
הוספֿה	הויסאָפֿע,העסאָפֿע
הוספֿות	הויסאָפֿעס,העסאָפֿעס
הוצאה	הויצאָע,העצאָע
הוצאָות	הויצאָעס,העצאָעס
הוצאָות־הדרך	הויצאָעס־האַדערעך
הוראה	הויראָע
הורג	הוירעג
הורג־נפֿשות	הוירעג־־נעפֿאָשעס,הוירעג־נעפֿאַשעס
הורגן	הוירעגן
הורדוס	הורדעס
הוריות	הויריִעס
הושע	הוישייע
הושענא	הוישײַנע,העשײַנע,שײַנע
הושענא־רבה	הוישײַנע־ראַבע,שײַנע־ראַבע
הושענות	הוישײַנעס,העשײַנעס
הזכּרה	האַזקאָרע,האַסקאָרע
הזכּרת־נשמות	האַזקאָרעס־נעשאָמעס,האַסקאָרעס־נעשאָמעס
הזמנה	האַזמאָנע
החלטה	האַכלאָטע
החתום־מטה	האַכאָסעם־מאַטאָ,האַכסומים־מאַטא
הידד	היידעד
הידור	הידער
הידורים	הידורים
היום	הײַעם
היום־תּאַמצנו	הײַעם־טעאַמציינו
היוצא לנו מזה	האַיויצע לאָנו מיזע
היוצא מדבֿרינו	האַיויצע מידוואָריינו
היוצא מזה	האַיויצע מיזע
היות	העיויס
היזק	העזעק
היזקות	העזייקעס
היטבֿ	הייטעוו
הײַנו	הײַנע
הײַנו־הך	הײַנע־האַך
היכא־תּימצא	הייכע־טימצע
היכל	הייכל
היכל־הקודש	הייכל־האַקוידעש
היכלות	הייכאָלעס
היכלים	הייכאָלים
הילד איננו	האַיעלעד איינענו
הילוך	הילעך
הילולא	הילולע
הילולא־וחינגא	הילולע־וועכינגע
הילכות	הילכעס
הילכתא־לימשיחא	הילכעסע־לימשיכע
היסח־הדעת	העסעך־האַדאַאַס
היפּוך	הייפּעך
היפּוכדיק	הייפּעכדיק
היפּוכים	היפּוכים
היקף	העקעף
היקפֿים	העקייפֿים
היקר	האַיאָקער
הירהור	הירער
הירהור־עבֿירה	הירער־אַוויירע
הירהור־תּשובֿה	הירער־טשוּווע
הירהורי־עבֿירה	הירהורע־אַוויירע
הירהורי־תּשובֿה	הירהורע־טשוּווע
הירהורים	הירהורים
היתּכן	האַיִטאָכן
היתּר	העטער
היתּר־הוראה	העטער־הויראָע
היתּר־עיסקא	העטער־איסקע
היתּר־שחיטה	העטער־שכיטע
היתּרים	העטיירים
הכּחשה	האַקכאָשע
הכּל מוכן	האַקל מוכן
הכּל־בכּל	האַקל־באַקל
הכּל־בכּל־מכּל	האַקל־באַקל־מיקל
הכּל־בכּל־מכּל־פֿלעקל	האַקל־באַקל־מיקל־פֿלעקל
הכּלל	האַקלאַל
הכּצעקתה	האַקצאַקאָסע
הכבדה	האַכבאָדע
הכנה	האַכאָנע
הכנות	האַכאָנעס
הכנסה	האַכנאָסע
הכנסת־אורחים	האַכנאָסעס־אָרכים
הכנסת־כּלה	האַכנאָסעס־קאַלע
הכנעה	האַכנאָע
הכרזה	האַכראָזע
הכרח	העכרייעך,העכרעך
הכרעה	האַכראָע
הכשר	העכשער
הכשרה	האַכשאָרע
הכשרים	העכשיירים
הלבשה	האַלבאָשע
הלוואה	האַלוואָע
הלוואַי	אַלעווײַ,האַלעווײַ
הלך משה־מרדכי	האָלעך מוישע־מאָרטכע
הלכה	האַלאָכע
הלכה למשה מסיני	האַלאָכע לעמוישע מיסינײַ
הלל	האַלעל,הילעל
הלל הזקן	הילעל האַזאָקן
הללויה	האַלעלוּיאָ
הללויהס	האַלעלוּיאָס
הלמאַי	האַלמײַ,האַלעמײַ,למײַ,לעמײַ
הלעיטני	האַליטייני
הלעיטניק	האַליטייניק
הלצה	האַלאָצע
המבֿדיל	האַמאַוודיל,האַמאַוודל
המון	האַמוין
המון־עם	האַמוין־אַם
המוציא	האַמויצע,מויצע
המכונה	האַמכונע,האַמעכונע
המליץ	האַמייליץ
המלך	האַמיילעך
המן	האָמען
המן הרשע	האָמען האַראָשע
המן־טאַש	האָמענטאַש
המנס	האָמענס
המפּה	האַמאַפּע
המפּיל	האַמאַפּל
המפֿורסם	האַמעפֿאָרסעם,האַמעפֿורסעם
המצאה	האַמצאָע
המשך	העמשעך
המשכים	העמשייכים
הן… הן…	הען
הן־צדק	הען־צעדעק
הנאה	האַנאָע
הנבֿיא	האַנאָווי
הנבֿיאה	האַנעוויִע
הנה	היניי
הנהגה	האַנהאָגע
הנחה	האַנאָכע
הני־מילי	האַנע־מילע
הניזכּר לעיל	האַניסקער לעייל
הנ״ל	האַנאַל
הס־מלהזכּר	האַס־מילעהאַסקער
הסברה	האַסבאָרע
הסבֿ־בעט	העסעבעט
הסגת־גבֿול	האַסאָגעס־גוווּל
הסכּם	העסקעם
הסכּם־כּולם	העסקעם־קולעם
הסכּמה	האַסקאָמע
הסכּמס	העסקעמס
הספּד	העספּעד
הספּדים	העספּיידים
הסתּדרותּ	היסטאַדרוט
הסתּלקות	היסטאַלקעס
הסתּפּקות	היסטאַפּקעס
העוויה	האַווײַע
העזה	האָזע
העיקר שכחתּי	האָיִקער שאָכאַכטי
הערה	העאָרע
הערות	העאָרעס
העתּקה	האַטאָקע
הפּה שאָסר הפּה שהתּיר	האַפּע שעאָסער האַפּע שעהיטער
הפֿוך	האָפֿעך
הפֿטורה	האַפֿטוירע
הפֿך	העפֿעך
הפֿכים	האַפֿאָכים
הפֿלא־ופֿלא	האַפֿלע־וואָפֿעלע
הפֿסד	העפֿסעד
הפֿסד־מרובה	העפֿסעד־מערובע
הפֿסדים	העפֿסיידים
הפֿסק	העפֿסעק
הפֿסקה	האַפֿסאָקע
הפֿסקים	העפֿסייקים
הפֿקר	העפֿקער
הפֿקרות	העפֿקיירעס
הצדיק	האַצאַדיק
הצטרכות	היצטאַרכעס
הצלה	האַצאָלע
הצלחה	האַצלאָכע
הצפֿירה	האַצפֿירע
הקדוש	האַקאָדעש
הקדוש־ברוך־הוא	האַקאָדעש־באָרכו
הקדמה	האַגדאָמע
הקדש	העגדעש
הקדשים	העגדיישים
הקיצה	האָקיצאָ
הקפּדה	האַקפּאָדע
הקפֿה	האַקאָפֿע
הקפֿות	האַקאָפֿעס
הר־הבית	האַר־האַבאַיִס
הר־הזיתים	האַר־האַזייסים
הר־שׂעיר	האַר־סעיִר
הראשון	האָרישן
הרבֿ	האָראַוו
הרג	הערעג
הרגל	הערגל
הרגל נעשׂה טבֿע	הערגל נאַאַסע טעווע,הערגל נײַסע טעווע
הרגלים	הערגיילים
הרגע	האַרגע
הרגעט	האַרגעט
הרגען	האַרגען
הרגענען	האַרגענען
הרגעסט	האַרגעסט
הרגעסטו	האַרגעסטו
הרוג	האָרעג
הרוגי־	האַרוגע
הרוגים	האַרוגים
הרחבֿה	האַרכאָווע
הרחבֿהדיק	האַרכאָוועדיק
הרחבֿת־הדעת	האַרכאָוועס־האַדאַאַס
הרי־אַתּ	האַריי־אַט
הרי־אַתּ מקודשת	האַריי־אַט מעקודעשעס
הרי־חושך	האָרע־כוישעך
הריגה	האַריגע
הריגות	האַריגעס
הרים־וגבֿעות	האָרים־אוגוואָעס
הרכּבֿה	האַרקאָווע
הרף־עין	הערעף־אַיִן
הרשאה	האַרשאָע
הרשע	האַראָשע
הרת־עולם	האַראַס־אוילעם
השאָרת־הנפֿש	האַשאָרעס־האַנעפֿעש
השבעה	האַשבאָע
השבֿת־אַבֿדה	האַשאָוועס־אַוויידע
השגחה	האַשגאָכע
השגחה־עליונה	האַשגאָכע־עליוינע
השגחה־פּרטית	האַשגאָכע־פּראָטעס
השכּמה	האַשקאָמע
השלמה	האַשלאָמע
השם ינקום דמו	האַשעם ייִנקאָם דאָמוי
השם ינקום דמם	האַשעם ייִנקאָם דאָמאָם
השם יצילנו	האַשעם יאַציליינו
השם ירחם	האַשעם יעראַכעם
השם ישמרנו	האַשעם ייִשמעריינו
השם־יתברך	האַשעם־ייִסבאָרעך
השמטה	האַשמאָטע
השערה	האַשאָרע
השערות	האַשאָרעס
השפּעה	האַשפּאָע
השפּעות	האַשפּאָעס
השקפֿה	האַשקאָפֿע
השקפֿות	האַשקאָפֿעס
השתּדלות	הישטאַדלעס
השתּנה	האַשטאָנע,שטאָנע
השתּפּכות	הישטאַפּכעס
השתּפּכות־הלבֿ	הישטאַפּכעס־האַלעוו
השתּפּכות־הנפֿש	הישטאַפּכעס־האַנעפֿעש
השׂגה	האַסאָגע
השׂכּלה	האַסקאָלע
התּיקווה	האַטיקוואָ
התבודדות	היסבוידעדעס
התבוננות	היסבוינענעס
התגלות	היסגאַלעס
התחזקות	היסכאַסקעס
התחײַבֿות	היסכײַוועס
התחײַבֿותן	היסכײַוועסן
התחלה	האַסכאָלע
התלהבֿות	היסלײַוועס
התמדה	האַסמאָדע
התמנות	היסמאַנעס
התנגדות	היסנאַגדעס
התנהגות	היסנײַגעס
התנצלות	היסנאַצלעס
התעוררות	היסוירערעס
התפּעלות	היספּײַלעס
התקרבֿות	היסקאַרוועס
התראה	האַסראָע
התרוממות	היסרוימעמעס
ו…	או…,וו…,ווע…
ו	וואָוו
ואָדר	ווייאָדער
ואָהבֿתּ לרעך כּמוך	וועאָהאַווטאָ לערעיאַכאָ קאָמויכאָ
ואיננו	וועיינענו
וארא	וואָיירע
ואתחנן	וואָעסכאַנען
ובפֿרט	אוביפֿראַט
ובֿכן	אוּווכיין
ודו״ק	וודאָק,וועדײַעק וועסימצע קאַל
ודי לחכּימא ברמיזא	וועדײַ לאַכקימע בירמיזע
ודי למבֿין	וועדײַ לאַמייוון
ודי לנבֿון	וועדײַ לאַנאָוון
ודייק ותמצא קל	וועדײַעק וועסימצע קאַל
והאָ־ראַיה	וועהאָ־רײַע
והוא־רחום	וווּראַכעם
והיום	וועהײַעם
והילד איננו	וועהאַיעלעד איינענו
והשנית	וועהאַשיינעס
וואָוו	וואָוו
ווידוי	ווידע
ווידויים	ווידויִם
ווידערקול	ווידערקאָל
ווידערקולות	ווידערקוילעס
וויכּוח	וויקועך
וויכּוחים	וויקוכים
וויתּור	וויטער
וויתּורים	וויטורים
וולד	וולאַד
וולדן	וולאַדן
ווסתּ	וועסט
ווסתּן	וועסטן
וועד	וואַאַד
וועד־אַרבע־אַרצות	וואַאַד־אַרבאַ־אַראָצעס
וועדים	וואַדים
וושט	וויישעט
וותּרן	וואַטרען
וותּרנות	וואַטראָנעס
וותּרנטע	וואַטרענטע
וותּרנים	וואַטראָנים
וותיק	וואָסעק
וותיקים	וואָסיקים
וותיקין	וואָסיקן
וזאת־הברכה	וועזויס־האַבראָכע
ויאכלו	וואַיאָכלו
ויבֿוא המן	וואַיאָווע האָמען
ויבֿרח	וואַייִוורעך
ויגש	וואַייִגעש
ויהי	ווײַהי
ויהי היום	ווײַהי האַיוים
ויהי רצון	ווײַהי ראָצן
ויזתא	ווײַזאָסע
ויחד־יתרודיק	וואַיִכעד־ייִסרעדיק
ויחי	וואַיעכי
וילך	וואַייילעך
ויצא	וואַיייצע
ויצמח־פּורקניה	וואַיאַצמעך־פּורקאָנע
ויצעקו	וואַיִצאַקו
ויקהל	וואַיאַקהעל
ויקראָ	וואַייִקראָ
וירא	וואַייירע
וישבֿ	וואַייישעוו
וישלח	וואַייִשלעך
ויתרוצצו	וואַיִסרויצעצו
וכּדומה	וועקעדוימע
וכדומה	אוכדוימע
וכרות	וועכאָרעס
ולמאַי נפֿקא־מינה	אולמײַ נאַפֿקע־מינע
ונאמר אָמן	ווענוימער אָמיין
ונתנה־תּוקף	אונסאַנע־טויקעף
ונתנו	ווענאָסנו
ועל־כּולם	וועאַל־קולעם
וצדקתך	ווייציטקאָסכע
ושתּי	וואַשטע
ושתּין	וואַשטען
ושתּיס	וואַשטעס
ז	זײַען
זאבֿ	זייוו
זאת־חנוכּה	זויס־כאַנוקע
זבֿולן	זוווּלן
זבֿחים	זוואָכים
זבֿים	זאָווים
זה בכּה וזה בכּה	זע בעקוי וועזע בעקוי
זה בכה וזה בכה	זע בעכוי וועזע בעכוי
זה נופֿל וזה קם	זע נויפֿל וועזע קאָם
זה־הרגע	זע־האָרעגע
זהבֿ	זאָהאָוו
זהבֿ־טהור	זאָהעוו־טאָהער
זהובֿ	זאָהעוו
זהובֿים	זעהוּווים
זהיר־וזהיר	זאָהער־וועזאָהער
זהירות	זעהירעס
זו תּורה וזו שׂכרה	זוי טויראָ וועזוי סכאָראָ
זוגות	זוגעס
זוגתו	זוגאָסוי
זוגתי	זוגאָסי
זוגתך	זוגאָסכע
זוהר	זויער
זוכה	זויכע
זוכה־בגורל	זויכע־בעגוירל
זול	זאָל
זולל	זוילעל
זולל־וסובֿא	זוילעל־וועסויווע
זולל־וסובֿאניק	זוילעל־וועסויוועניק
זונה	זוינע
זונות	זוינעס
זיוו־השכינה	זיוו־האַשכינע
זיווג	זיוועג
זיווגים	זיוווּגים
זיין	זײַען
זילזול	זילזל
זילזולים	זילזולים
זילפּה	זילפּע
זיקנה	זיקנע
זכּרון	זיקאָרן
זכור־ברית	זכויר־בריס,סכויר־בריס
זכות	זכוס ,סכוס 
זכות־אָבֿות	זכוס־אָוועס,סכוס־אָוועס
זכות־הקיום	זכוס־האַקיִעם,סכוס־האַקיִעם
זכות־עצמו	זכוס־אַצמע,סכוס־אַצמע
זכותו יגן	זכוסע יאָגן,סכוסע יאָגן
זכותו יגן עלינו	זכוסע יאָגן אָליינו,סכוסע יאָגן אָליינו
זכותים	זכוסים,סכוסים
זכותם יגן	זכוסעם יאָגן,סכוסעם יאָגן
זכותם יגן עלינו	זכוסעם יאָגן אָליינו,סכוסעם יאָגן אָליינו
זכותן	זכוסן,סכוסן
זכיה	זכיִע,סכיִע
זכיות	זאָכיִעס,זכיִעס,סכיִעס
זכיותן	זאָכיִעסן
זכר	זאָכער,זייכער
זכר צדיק לבֿרכה	זייכער צאַדיק לעווראָכע
זכר־לחורבן	זייכער־לעכורבם
זכרונה לבֿרכה	זיכרוינע לעווראָכע
זכרונו לבֿרכה	זיכרוינע לעווראָכע
זכרונות	זיכרוינעס
זכרונם לבֿרכה	זיכרוינאָם לעווראָכע
זכרות	זאַכרעס
זכריה	זכאַריע,סכאַריע
זכריהן	סכאַריען
זכריהס	סכאַריעס
זכרים	זכאָרים,סכאָרים
ז״ל	זאַל
זלמן	זאַלמען
זמירות	זמירעס
זמן	זמאַן
זמן־שׂימחתנו	זמאַן־סימכעסיינע
זמנים	זמאַנים
זמר	זעמער
זנבֿ	זאָנעוו
זנבֿים	זנאָווים
זנות	זנוס
זצ״ל	זאַצאַל
זקן	זאָקן
זקן־ורגיל	זאָקן־וועראָגל
זקנה	זיקנע,זקאָנע,זקיינע,סקאָנע,סקיינע
זקנים	זקאָנים,זקיינים,סקאָנים,סקיינים
זרובבֿל	זרובאָוול
זרח	זאָרעך
זרחן	זאָרעכן
זרחס	זאָרעכס
זריעה	זריִע
זרע	זערע
זרעים	זראָיִם
זרקען	זאַרקען
זרש	זערעש
ח	כעס
חאַסלערע	כאַסלערע
חב״ד	כאַבאַד
חבדניצע	כאַבאַדניצע
חבדניק	כאַבאַדניק
חבדער	כאַבאַדער
חבֿורה	כאַוווּרע
חבֿורות	כאַוווּרעס
חבֿלי־יצירה	כעוולע־יעצירע
חבֿלי־לידה	כעוולע־ליידע
חבֿלי־משיח	כעוולע־מעשיִעך
חבֿקוק	כאַווקוק
חבֿר	כאָווער,כאַווער
חבֿר־לאַווער	כאַווער־לאַווער
חבֿר־לאַפּ	כאַווערלאַפּ
חבֿר־לדעה	כאַווער־לעדייע
חבֿרה	כאַוויירע,כעוורע
חבֿרה־מאַן	כעוורעמאַן
חבֿרה־קדישא	כעוורע־קעדישע
חבֿרהניק	כעוורעניק
חבֿרון	כעוורען
חבֿרות	כעוורעס
חבֿרותא	כאַוורוסע
חבֿרותות	כאַוורוסעס
חבֿרט	כאַווערט
חבֿרטאָרין	כאַווערטאָרן
חבֿרטאָרינס	כאַווערטאָרנס
חבֿרטע	כאַווערטע
חבֿרטעס	כאַווערטעס
חבֿריה	כעוורײַע
חבֿרייא	כעוורײַע
חבֿרים	כאַוויירים
חבֿרים־לדעה	כאַוויירים־לעדייע
חבֿריש	כאַוועריש
חבֿרן	כאַווערן
חבֿרסט	כאַווערסט
חבֿרסטו	כאַווערסטו
חבֿרשאַפֿט	כאַווערשאַפֿט
חג־האָסיף	כאַג־האָאָסיף
חג־הביכּורים	כאַג־האַביקורים
חג־המצות	כאַג־האַמאַצעס
חגא	כאָגע
חגאָות	כאַגאָעס
חגות	כאָגעס
חגי	כאַגע
חגיגה	כאַגיגע
חד־בדרא	כאַד־בעדאָרע
חד־גדיא	כאַד־גאַדיע
חדווה	כעדווע
חדקל	כידעקל
חדר	כיידער
חדר־לפֿנים־מחדר	כיידער־ליפֿנים־מיכיידער
חדר־מיוחד	כיידער־מעיוכעד
חדר־מתוקן	כיידער־מעסוקן
חדר״ג	כאַדראַג
חדרי־חדרים	כאַדרע־כאַדאָרים
חדרים	כאַדאָרים
חדרים־מתוקנים	כאַדאָרים־מעסוקאָנים
חדשות	כאַדאָשעס
חדשים	כאַדאָשים
חובֿ	כויוו
חובֿבֿ־ציון	כויוועוו־ציִען
חובֿבֿי־ציון	כאָוועווע־ציִען
חובֿבֿי־שׂפֿת־עבֿר	כאָוועווע־ספֿאַס־אייווער
חובֿות	כויוועס
חובֿות־הלבֿבֿות	כויוועס־האַלוואָוועס
חודש	כוידעש
חווה	כאַווע
חוות־דעת	כאַוועס־דאַאַס
חוזה	כויזע
חוזים	כויזים
חוזק	כויזעק
חוזקן	כויזעקן
חוזר	כויזער
חוזר־בתּשובֿה	כויזער־ביטשוּווע
חוזרים	כאָזרים
חוזרים־בתּשובֿה	כאָזרים־ביטשוּווע
חוט־המשולש	כוט־האַמשולעש
חוט־השדרה	כוט־האַשעדרע
חוטא	כויטע
חוטא־בעגל	כויטע־בייגל,כויטע־בעייגל
חוטא־ומחטיא	כויטע־אומאַכטי
חוטא־ומחטיא את הרבים	כויטע־אומאַכטי עס האָראַבים
חוטאים	כאָטים,כויטים
חוטאן	כויטען
חוטם	כויטעם
חוכּר	כויקער
חוכּרים	כאָקרים
חוכא־וטלולא	כוכע־אוטלולע
חוכא־טלולא	כוכע־טלולע
חול־המועד	כאַלעמויד,כאָלעמויד
חול־המועדיק	כאַלעמוידיק,כאָלעמוידיק
חול־המועדיקן	כאַלעמוידיקן,כאָלעמוידיקן
חול־המועדיקס	כאַלעמוידיקס,כאָלעמוידיקס
חול־המועדיקע	כאַלעמוידיקע,כאָלעמוידיקע
חול־המועדיקער	כאַלעמוידיקער,כאָלעמוידיקער
חולה	כוילע
חולה־מסוכּן	כוילע־מעסוקן
חולה־נופֿל	כוילע־נויפֿל
חולהוואַטע	כוילעוואַטע
חולי־הנפֿש	כוילי־האַנעפֿעש
חולי־נופֿלים	כוילי־נויפֿלים
חולים	כוילים
חולים־מסוכּנים	כוילים־מעסוקאָנים
חולים־נופֿלים	כוילים־נויפֿלים
חולין	כולין
חולם	כוילעם
חולם־נאָז	כוילעם־נאָז
חולנית	כוילאַנעס
חולק	כוילעק
חולקים	כאָלקים
חולשה	כולשע
חומד־ממון	כוימעד־מאָמען
חומדי־ממון	כאָמדע־מאָמען
חומר	כוימער
חומר־היולי	כוימער־היִולי
חומרא	כומרע
חומרות	כומרעס
חומש	כומעש
חומשים	כומאָשים
חונף	כוינעף
חונפֿים	כאָנפֿים
חופּה	כופּע
חופּה־וקידושין	כופּע־וועקדושן,כופּע־וועקידושן
חופּות	כופּעס
חוץ	כוץ
חוץ־לאָרץ	כוץ־לאָאָרעץ
חוץ־לגדר	כוץ־לאַגעדער
חוץ־לדרך־הטבֿע	כוץ־לעדערעך־האַטעווע
חוץ־לזה	כוץ־לעזע
חוץ־למחנה	כוץ־לאַמאַכנע
חוצפּה	כוצפּע
חוצפּהניצע	כוצפּעניצע
חוצפּהניק	כוצפּעניק
חוק	כאָק
חוק־ולא־יעבֿר	כאָק־וועלוי־יאַווער
חוק־לישׂראל	כאָק־לעיִסראָעל
חוקים	כוקים
חוקל	כאָקל
חוקר	כויקער
חוקר־ודורש	כויקער־וועדוירעש
חוקרים	כויקרים
חורבן	כורבם,כורבן
חורבן־בית־ראשון	כורבם־באַיִס־רישן,כורבן־באַיִס־רישן
חורבן־בית־שני	כורבם־באַיִס־שייני,כורבן־באַיִס־שייני
חורבן־ליטעראַטור	כורבם־ליטעראַטור,כורבן־ליטעראַטור
חורבנות	כורבוינעס
חורבֿה	כורווע
חורבֿות	כורוועס
חורש	כוירעש,כיירעש
חוש	כוש
חוש־הטעם	כוש־האַטאַם
חוש־המישוש	כוש־האַמישעש
חוש־הראיה	כוש־האַריִע
חוש־הריח	כוש־האַרייעך
חוש־השמיעה	כוש־האַשמיִע
חושד	כוישעד
חושד־בכּשרים	כוישעד־ביקשיירים
חושים	כושעם
חושימדיק	כושימדיק
חושך	כוישעך
חושך־ואַפֿלה	כוישעך־וואַאַפֿיילע
חושך־וחלקלקות	כוישעך־וואַכלאַקלאַקעס
חושך־מצרים	כוישעך־מיצראַיִם
חושכן	כוישעכן
חושן	כוישן
חושן־מישפּט	כוישן־מישפּעט
חותם	כויסעם
חותם־המלכות	כויסעם־האַמאַלכעס
חזיון	כיזויען
חזיונות	כיזיוינעס
חזיר	כאַזער
חזירטע	כאַזערטע
חזירטעס	כאַזערטעס
חזירײַ	כאַזערײַ
חזירײַען	כאַזערײַען
חזירים	כאַזיירים
חזירימלעך	כאַזיירימלעך
חזיריש	כאַזעריש
חזירישן	כאַזערישן
חזירישע	כאַזערישע
חזירישער	כאַזערישער
חזירל	כאַזערל
חזירניצע	כאַזערניצע
חזירניצעס	כאַזערניצעס
חזירניק	כאַזערניק
חזירניקעס	כאַזערניקעס
חז״ל	כאַזאַל
חזן	כאַזן
חזנדל	כאַזנדל
חזנות	כאַזאָנעס
חזנטע	כאַזנטע
חזנטעס	כאַזנטעס
חזנים	כאַזאָנים
חזנימלעך	כאַזאָנימלעך
חזניש	כאַזאָניש
חזנס	כאַזנס
חזק	כאַזאַק
חזקה	כאַזאָקע
חזר	כאַזער
חזרה	כאַזאָרע
חזרט	כאַזערט
חזרן	כאַזערן
חזרנדיק	כאַזערנדיק
חזרסט	כאַזערסט
חזרת־הש״ץ	כאַזאָרעס־האַשאַץ
חטא	כעט
חטאָים	כאַטאָיִם
חטאת־נעורים	כאַטעס־נעורים
חטאָתי	כאָטאָסי
חטף	כאַטעף
חי	כײַ
ח״י	כײַ
חי־וקים	כײַ־וועקײַעם
חיבוט־הקבֿר	כיבעט־האַקייווער
חיבוק־ונישוק	כיבעק־ווענישעק
חיבור	כיבער
חיבורים	כיבורים
חיבת־ציון	כיבעס־ציִען
חידה	כידע
חידוד	כידעד
חידודים	כידודים
חידוש	כידעש
חידושי־תּורה	כידושע־טוירע
חידושים	כידושים
חידושים־ונפֿלאָות	כידושים־וועניפֿלאָעס
חידושן	כידעשן
חידות	כידעס
חיה	כײַע
חיה־רעה	כײַע־ראָע
חיובֿ	כיִעוו
חיובֿים	כיִוּווים
חיונה	כאַיונע
חיות	כײַעס,כיִעס
חיותן	כיִעסן
חיזוק	כיזעק
חיזוקים	כיזוקים
חיי־אָדם	כײַע־אָדעם
חיי־עולם	כײַע־אוילעם
חיי־שעה	כאַיעשאָ
חיי־שׂרה	כײַע־סאָרע
חייבֿ	כײַעוו
חייבֿ־מיתה	כײַעוו־מיסע
חייבֿים	כאַיאָווים
חייט	כײַעט
חייטים	כאַיאָטים
חייל	כאַיִל
חיילות	כאַיאָלעס
חיים	כאַיִם
חיימטע	כאַיִמטע
חיימס	כאַיִמס
חיימען	כאַיִמען
חייִש	כאַיִש
חילול	כילעל
חילול־הכּבֿוד	כילעל־האַקאָוועד
חילול־המת	כילעל־האַמעס
חילול־הקודש	כילעל־האַקוידעש
חילול־השם	כילעל־האַשעם
חילול־התּורה	כילעל־האַטוירע
חילול־קודש	כילעל־קוידעש
חילול־שבת	כילעל־שאַבעס
חילולים	כילולים
חילוף	כילעף
חילופֿים	כילופֿים
חילופֿן	כילעפֿן
חילוק	כילעק
חילוקי־דעות	כילוקע־דייעס
חילוקים	כילוקים
חינוך	כינעך
חיסור	כיסער
חיצון	כיצן
חיצוניות	כיצויניִעס
חיצונים	כיצוינים
חיריק	כירעק
חיתּוך־הדיבור	כיטעך־האַדיבער
חית	כעס
חכם	כאָכעם
חכם־בלילה	כאָכעם־באַלײַלע
חכם־להרע	כאָכעם־לעהאָרע
חכם־מופֿלג	כאָכעם־מופֿלעג
חכם־עתּיק	כאָכעם־אַטעק
חכמה	כאַכאָמע,כאָכמע
חכמה־חיצונית	כאָכמע־כיצוינעס
חכמה־נסתּרת	כאָכמע־ניסטערעס
חכמהן	כאָכמען
חכמהנען	כאָכמענען
חכמות	כאָכמעס
חכמות־חיצוניות	כאָכמעס־כיצויניִעס
חכמי־הלעזשאַנקע	כאַכמע־האַלעזשאַנקע
חכמי־התּלמוד	כאַכמע־האַטאַלמוד
חכמי־ישׂראל	כאַכמע־ייִסראָעל
חכמים	כאַכאָמים
חכמים־מופֿלגים	כאַכאָמים־מופֿלאָגים
חכמים־עתּיקים	כאַכאָמים־אַטיקים
חכמינו זכרונם לבֿרכה	כאַכאָמיינו זיכרוינעם לעווראָכע
חכמניות	כאָכמאַניִעס
חכמנית	כאָכמאַניס
חכמת	כאַכיימעס
חכמת־	כאָכמעס־
חכמת־ה…	כאָכמעס־האַ…
חכמת־הדאָקטאָריע	כאָכמעס־האַדאָקטאָריע
חכמת־החשבון	כאָכמעס־האַכעזשבם
חכמת־החשבון־והמדידה	כאָכמעס־האַכעזשבם־וועהאַמדידע
חכמת־היד	כאָכמעס־האַיאַד
חכמת־היהדות	כאָכמעס־האַיאַאַדעס
חכמת־הפּרצוף	כאָכמעס־האַפּאַרצעף
חכמת־התּכונה	כאָכמעס־האַטכונע
חכמת־יוון	כאָכמעס־יאָוון
חל	כאַל
חלאָים	כאַלאָיִם
חלאַת	כאַלאַס
חלאַתן	כאַלאַסן
חלבנה	כעלבנע
חלבֿ	כיילעוו
חלבֿן	כיילעוון
חלה	כאַלע
חלום	כאָלעם
חלומות	כאַלוימעס
חלומט	כאָלעמט
חלומסט	כאָלעמסט
חלומען	כאָלעמען
חלומענדיק	כאָלעמענדיק
חלוץ	כאָלעץ
חלוצה	כאַלוצע
חלוצות	כאַלוצעס
חלוצים	כאַלוצים
חלוקה	כאַלוקע
חלוש	כאָלעש
חלוש־ריאה	כאָלעש־רייע
חלושי־ריאה	כלושע־רייע
חלושים	כאַלושים
חלות	כאַלעס
חלילה	כאָלילע
חלילה־וחס	כאָלילע־וועכאַס
חליען	כאָליען
חליצה	כאַליצע,כליצע
חלל	כאָלעל
חלף	כאַלעף
חלפֿים	כאַלאָפֿים
חלפֿן	כאַלפֿן
חלפֿנות	כאַלפֿאָנעס
חלפֿנים	כאַלפֿאָנים
חלק	כיילעק
חלק־לעולם־הבא	כיילעק־לעוילעם־האַבע
חלקים	כאַלאָקים
חלש	כאַלעש
חלשות	כאַלאָשעס
חלשותדיק	כאַלאָשעסדיק
חלשט	כאַלעשט
חלשן	כאַלעשן
חלשנדיק	כאַלעשנדיק
חלשסט	כאַלעשסט
חם	כאַם
חמור	כאַמויער,כאַמויר,כאַמער
חמור־אייזל	כאַמערייזל
חמורים	כאַמוירים
חמוריש	כאַמויריש
חמימה	כמימע
חמימותדיק	כמימעסדיק
חמישה חומשי־תּורה	כאַמישע כומשע־טוירע
חמישה־עשׂר	כאַמישאָסער
חמישה־עשׂר בשבֿט	כאַמישאָסער בישוואַט
חמישי	כאַמישי,כמישי
חמישים	כאַמישים,כמישים
חמץ	כאָמעץ
חמרים	כמאָרים
חן	כיין
ח״ן	כיין
חן־גריבעלע	כיין־גריבעלע
חן־גריבעלעך	כיין־גריבעלעך
חנא	כאָנע
חנאן	כאָנען
חנאס	כאָנעס
חנדל	כיינדל
חנדלעך	כיינדלעך
חנדלען	כיינדלען
חנה	כאַנע
חנהן	כאַנען
חנהס	כאַנעס
חנוכּה	כאַנוקע,כאַניקע
חנוכּת־הבית	כאַנוקעס־האַבאַיִס
חנוך	כאַנויך,כאַנעך,כינעך
חנוכן	כאַנויכן,כאַנעכן
חנוכס	כאַנויכס,כאַנעכס
חנופֿה	כאַנופֿע,כנופֿע
חניפֿה	כאַניפֿע,כניפֿע
חניפֿהלע	כניפֿעלע
חניפֿהלעך	כניפֿעלעך
חניפֿהניק	כאַניפֿעניק,כניפֿעניק
חניפֿהניקעס	כניפֿעניקעס
חניפֿושניצע	כאַניפֿושניצע,כניפֿושניצע
חניפֿושניק	כאַניפֿושניק,כניפֿושניק
חניפֿות	כניפֿעס
חניפֿותניצע	כאַניפֿעסניצע,כניפֿעסניצע
חניפֿותניצעס	כניפֿעסניצעס
חניפֿותניק	כאַניפֿעסניק,כניפֿעסניק
חניפֿותניקעס	כניפֿעסניקעס
חנן	כאָנען
חנניה	כאַנאַניע
חננס	כאָנענס
חננען	כאָנענען
חנעוודיק	כיינעוודיק
חנפֿים	כאַנייפֿים
חנפֿן	כאַנפֿן
חנפֿנים	כאַנפֿאָנים
חנפֿען	כאַנפֿען
חנפֿענען	כאַנפֿענען
חנק	כענעק
חס	כאַס,כאָס
חס־וחלילה	כאַס־וועכאָלילע
חס־ושלום	כאַס־וועשאָלעם
חסד	כעסעד
חסד־של־אמת	כעסעד־שעל־עמעס
חסדים	כאַסאָדים,כסאָדים
חסיד	כאָסיד
חסידאַרניע	כסידאַרניע
חסידאַרניעס	כסידאַרניעס
חסידות	כסידעס
חסידי־אומות־העולם	כסידע־אומעס־האָוילעם
חסידי־אַשכּנז	כסידע־אַשקענאַז
חסידים	כסידים
חסידיש	כסידיש
חסידישן	כסידישן
חסידישע	כסידישע
חסידישער	כסידישער
חסידל	כאָסעדל
חסידקע	כאָסידקע
חסר	כאָסער
חסר־דעה	כאָסער־דייע,כסאַר־דייע
חסר־דעהניק	כאָסער־דייעניק
חסר־דעהש	כסאַר־דייעש
חסרון	כעסאָרן
חסרון־כּיס	כעסאָרן־קיס
חסרונות	כעסרוינעס
חסרונים	כעסרוינים
חפֿני	כאָפֿני
חפֿץ	כייפֿעץ
חפֿצות	כעפֿצעס
חפֿציות	כעפֿצעס
חפֿצים	כפֿאָצים,כפֿייצים
חצוף	כאָצעף
חצוף־מחוצף	כאָצעף־מעכוצעף
חצופֿה	כאַצופֿע,כצופֿע
חצופֿים	כאַצופֿים,כצופֿים
חצות	כצאָס
חצי	כאָצע
חצי לי חצי לך	כאָצע לי כאָצע לאָך
חצי שלי וחצי שלך	כאָצע שעלי וועכאָצע שעלאָך
חצי־דבֿר	כאָצע־דאָווער
חצי־חודש	כאָצע־כוידעש
חצי־חינם	כאָצע־כינעם
חצי־שבתל	כאָצע־שאַבעסל
חציפֿות	כאַציפֿעס,כציפֿעס
חציצה	כאַציצע,כציצע
חצר	כאָצער
חצר־המלכות	כאַצאַר־האַמאַלכעס
חצרות	כציירעס
חצרות־מלכים	כאַציירעס־מעלאָכים,כציירעס־מעלאָכים
חצרים	כאַציירעס
חקירה	כאַקירע,כקירע
חקירה־ודרישה	כאַקירע־דרישע,כאַקירע־וועדרישע,כקירע־דרישע,כקירע־וועדרישע
חקירהן	כאַקירען,כקירען
חקירות	כאַקירעס,כקירעס
חקרן	כאַקרען
חקרנים	כאַקראָנים
חקרנען	כאַקרענען
חקת	כוקעס
חרבֿונה	כאַרוווינע
חרד	כאָרעד
חרדים	כאַריידים
חרדיש	כאַריידיש
חרובֿ	כאָרעוו
חרובֿ־ונחרבֿ	כאָרעוו־ווענעכרעוו
חרון־אַף	כאָרן־אַף
חרוסת	כאַרויסעס,כרויסעס
חרוף־נפֿש	כיירעף־נעפֿעש
חרוץ	כאָרעץ
חרוצה	כאַרוצע
חרוצים	כאַרוצים
חרטה	כאַראָטע,כראָטע
חרטומים	כאַרטומים
חרטות	כראָטעס
חריף	כאַרעף
חריפֿות	כאַריפֿעס,כריפֿעס
חריפֿים	כאַריפֿים,כריפֿים
חרם	כיירעם
חרם־דרבנו־גרשם	כיירעם־דעראַביינו־גערשאָם
חרם־קוויטל	כיירעם־קוויטל
חרמות	כאַראָמעס,כראָמעס
חרמים	כאַראָמים,כראָמים
חרפּה	כאַרפּע
חרפּות	כאַרפּעס
חרש שוטה וקטן	כיירעש שויטע וועקאָטן
חשבון	כעזשבם
חשבון־הנפֿש	כעזשבם־האַנעפֿעש
חשבון־צדק	כעזשבם־צעדעק
חשבונות	כעזשבוינעס
חשבונען	כעזשבענען
חשד	כשאַד
חשדים	כשאָדים
חשובֿ	כאָשעוו
חשובֿים	כאַשוּווים,כשוּווים
חשובֿן	כאָשעוון
חשובֿס	כאָשעווס
חשובֿע	כאָשעווע
חשובֿער	כאָשעווער
חשובֿערן	כאָשעווערן
חשובֿערס	כאָשעווערס
חשובֿערע	כאָשעווערע
חשובֿערער	כאָשעווערער
חשוד	כאָשעד
חשודים	כאַשודים,כשודים
חשוון	כעזשוון
חשיבֿות	כאַשיוועס,כשיוועס
חשכות	כאַשכעס
חשמונאָים	כאַשמענאָיִם
חשק	כיישעק
חשש	כשאַש
חשש־חמץ	כשאַש־כאָמעץ
חששות	כשאָשעס
חששים	כשאָשים
חשׂוך־בנים	כאָסעך־באָנים
חשׂוכי־בנים	כסוכע־באָנים
חתום־מטה	כאָסעם־מאַטע
חתומים־מטה	כסומים־מאַטע
חתונה	כאַסענע
חתונות	כאַסענעס
חתימה	כסימע
חתימה־געלט	כסימע־געלט
חתימה־טובֿה	כסימע־טויווע
חתימות	כסימעס
חתימת־זקן	כסימעס־זאָקן
חתלורע	כאַסלערע
חתליערע	כאַסלערע
חתמעט	כאַסמעט
חתמען	כאַסמען
חתמענען	כאַסמענען
חתן	כאָסן
חתן־בחור	כאָסן־באָכער
חתן־בראשית	כאָסן־בריישעס
חתן־דנן	כאַסאַן־דענאַן,כאָסן־דענאַן
חתן־היובֿל	כאַסאַן־האַיויוול
חתן־כּלה	כאָסנקאַלע
חתן־מאָל	כאָסנמאָל
חתן־תּורה	כאָסן־טוירע
חתנים	כאַסאַנים
חתנס	כאָסנס
ט	טעס
טבור־האָרץ	טאַבור־האָאָרעץ
טבעת־המלכות	טאַבאַאַס־האַמאַלכעס
טבעת־קידושין	טאַבאַאַס־קדושן,טאַבאַאַס־קידושן
טבֿול־יום	טוווּל־יאָם
טבֿיה	טעוויע
טבֿילה	טווילע
טבֿיעות־עין	טוויִעס־אַיִן
טבֿיעת־עין	טוויִעס־אַיִן
טבֿע	טעווע
טבֿריה	טוועריע
טבֿת	טייוועס
טהור	טאָהער
טהורים	טעהוירים
טהרה	טאַרע
טהרה־ברעט	טאַרע־ברעט
טהרה־שטיבל	טאַרע־שטיבל
טהרות	טאַרעס,טהאָרעס
טהרת־המשפּחה	טאַרעס־האַמישפּאָכע
ט״ו	טו
ט״ו בשבֿט	טו בישוואַט
טובֿה	טויווע
טובֿות	טויוועס
טובֿי־העיר	טוּוויי־האָיִר
טובֿיה	טוּוויע,טויוויע
טובֿיהן	טוּוויען
טובֿיהס	טוּוויעס
טובֿל	טויוול
טובֿלען	טויוולען
טובֿת־הכּלל	טויוועס־האַקלאַל
טובֿת־הנאה	טויוועס־האַנאָע
טומאה	טומע
טומטום	טומטעם
טועה	טויע
טועם	טויעם
טועם־טעם	טויעם־טאַם
טוען	טויען
טוענים	טאָיאַנים
ט״ז	טאַז
טיבֿיעות	טיוויעס
טיטוס הרשע	טיטעס האַראָשע
טילטול־הדרך	טילטל־האַדערעך
טינוף	טינעף
טינופֿת	טינויפֿעס
טיפּה	טיפּע
טיפּה־מן־הים	טיפּע־מין־האַיאַם
טיפּה־סרוחה	טיפּע־סרוכע
טיפּש	טיפּעש
טיפּשה	טיפּשע
טיפּשות	טיפּשעס
טיפּשים	טיפּשים
טירדה	טירדע
טירוף	טירעף
טירוף־הדעת	טירעף־האַדאַס
טירופֿים	טירופֿים
טירחא	טירכע
טירחה	טירכע
טית	טעס
טל	טאַל
טל־ומטר	טאַל־אומאָטער,טאַל־וועמאָטער
טלה	טאָלע,טלע
טלית	טאַלעס
טלית־קטן	טאַלעס־קאָטן
טליתים	טאַלייסים
טליתים־קטנים	טאַלייסים־קטאַנים
טמא	טאָמע
טמאים	טמעיִם
טמאניק	טאָמעניק
טעות	טאָעס
טעות־הדפֿוס	טאָעס־האַטפֿוס
טעותים	טעוסים
טעותן	טאָעסן
טעם	טאַם
טעמים	טײַמים
טענה	טײַנע
טענה־ומענה	טײַנע־אומײַנע
טענהט	טײַנעט
טענהן	טײַנען
טענהסט	טײַנעסט
טענהסטו	טײַנעסטו
טענות	טײַנעס
טענות־ותּבֿיעות	טײַנעס־אוטוויִעס
טפֿח	טעפֿעך
טפֿחים	טפֿאָכים
טפֿל	טאָפֿל
טפֿלים	טפֿיילים
טרוד	טאָרעד
טרודים	טרודים
טריף	טרייף
טריף־פּסול	טרייף־פּאָסל
טריפֿה	טרייפֿע
טריפֿהניצע	טרייפֿעניצע
טריפֿניאַק	טרייפֿניאַק
טריפֿנע	טרייפֿענע
טריפֿנעם	טרייפֿענעם
טריפֿנער	טרייפֿענער
טרפֿה	טרייפֿע
טרפֿות	טאַרפֿעס
י	יוד
יאכלוהו	יאָכלוהו
יאָר־עדות	יאָר־איידעס
יבבה	יאַבעבאָ
יבום	ייִבעם
יבשה	יאַבאָשע
יבשות	יאַבאָשעס
יבֿוא יומו	יאָווע יוימע
יבֿמות	יעוואָמעס
יבֿנה	יאַוונע
יבֿרכך	יעוואָרעכעכאָ
יגדל	ייִגדאַל
יגון־ואַנחה	יאָגן־וואַאַנאָכע
יגיע־כּפּו	יעגיִע־קאַפּע
יגיע־כּפּיו	יעגיִע־קאַפּעוו
יגיע־כּפּים	יעגיִע־קאַפּאַיִם
יגיע־כּפּימניק	יעגיִע־קאַפּאַיִמניק
יגיעת־כּפּו	יעגיִעס־קאַפּע
יגיעת־כּפּיו	יעגיִעס־קאַפּעוו
יגיעת־כּפּים	יעגיִעס־קאַפּאַיִם
יד	יאַד
יד־אַחת	יאַדאַכעס
יד־החזקה	יאַד־האַכאַזאָקע
ידוע	יעדוע
ידוע־לכּל	יעדוע־לאַקל
ידיד	יעדיד
ידיד־נאמן	יעדיד־נעמען
ידידי	יעדידי
ידידיה	יעדידיע
ידידים־נאמנים	יעדידים־נעמאָנים
ידים	יאָדאַיִם
ידיעה	יעדיִע
ידיעות	יעדיִעס
ידען	יאַדן
ידענות	יאַדאָנעס
ידענים	יאַדאָנים
יהדות	יאַאַדעס,יאַנדעס
יהואש	יעהויעש
יהודה	יעהודע
יהודה החסיד	יעהודע האַכאָסיד
יהודה הלווי	יעהודע האַלייווי
יהודה המכּבי	יעהודע האַמאַקאַבי
יהודה הנשׂיא	יעהודע האַנאָסי
יהודי	יעהודי
יהודית	יודיס,יודעס,יעהודיס
יהונתן	יעהוינעסן
יהושע	יעהוישוע,יעשוע
יהי	יעהי
יהי־אור	יעהי־אויר
יהי־רצון	יעהי־ראָצן
יואל	יויעל
יואלן	יויעלן
יואלס	יויעלס
יובֿל	יויוול
יוד	יוד
יודע	יעדייע
יודע־הכּל	יעדייע־האַקל
יודע־חן	יאָדע־כיין,יעדייע־כיין
יודע־נגן	יאָדע־נאַגיין,יעדייע־נאַגיין
יודע־ספֿר	יאָדע־סייפֿער,יעדייע־סייפֿער
יודע־שאינו־יודע	יעדייע־שעיינע־יעדייע
יודעים	יאָדים
יוון	יאָוון
יוונים	יעוואָנים
יווניש	יעוואָניש
יוחנן	יויכענען
יוחנן בן־זכּאי	יויכענען בען־זאַקײַ
יוכבֿד	יאָכוועט,יאָכעוועד,יאָכפֿעט
יוכבֿדן	יאָכעוועדן,יאָכפֿעטן
יוכבֿדס	יאָכעוועדס,יאָכפֿעטס
יולדת	יאָלדעס
יום	יאָם
יום א׳	יאָם אַלעף
יום ב׳	יאָם בייס
יום ג׳	יאָם גימל
יום ד׳	יאָם דאַלעט
יום ה׳	יאָם היי
יום ו׳	יאָם וואָוו
יום־הדין	יאָם־האַדין
יום־ולילה	יאָם־וואָלײַלע
יום־טובֿ	יאָנטעוו
יום־טובֿדיק	יאָנטעוודיק
יום־טובֿדיקן	יאָנטעוודיקן
יום־טובֿדיקס	יאָנטעוודיקס
יום־טובֿדיקע	יאָנטעוודיקע
יום־טובֿדיקער	יאָנטעוודיקער
יום־טובֿים	יאָנטויווים
יום־טובֿן	יאָנטעוון
יום־כּיפּור	יאָמקיפּער,יאָנקיפּער
יום־כּיפּור־קטן	יאָמקיפּער־קאָטן,יאָנקיפּער־קאָטן
יומא	יוימע
יומא־דפּגרא	יוימע־דעפּאַגרע
יומם־ולילה	יוימעם־וואָלײַלע
יונה	יוינע
יונהן	יוינען
יונהס	יוינעס
יונק	יוינעק
יונתן	יוינאָסן,יוינעסן
יונתנס	יוינאָסנס,יוינעסנס
יוסף	יאָסעף,יויסעף
יוסף דילה ריינה	יאָסעף דעלע ריינע,יויסעף דעלע ריינע
יוסף הצדיק	יאָסעף האַצאַדיק,יויסעף האַצאַדיק
יוסף הצדיקס	יאָסעף האַצאַדיקס,יויסעף האַצאַדיקס
יוספֿן	יאָסעפֿן,יויסעפֿן
יוספֿס	יאָסעפֿס,יויסעפֿס
יועץ	יויעץ
יופֿי	יויפֿע
יוצא	יויצע
יוצא־דופֿן	יויצע־דויפֿן
יוצא־דופֿנס	יויצע־דויפֿנס
יוצא־ונכנס	יויצע־וועניכנעס
יוצא־מן־הכּלל	יויצע־מין־האַקלאַל
יוצא־מן־הכּללן	יויצע־מין־האַקלאַלן
יוצאי־מצרים	יויצע־מיצראַיִם
יוצאים־מן־הכּלל	יויצים־מין־האַקלאַל
יוצר	יויצער
יוצר־משרתים	יויצער־מעשאָרסים
יוצר־משרתים ואשר משרתיו	יויצער־מעשאָרסים וואַשער מעשאָרסאָוו
יוצרות	יאָצרעס
יורד	יוירעד
יורדים	יאָרדים
יורה־דעה	יוירע־דייע
יורש	יוירעש
יורש־עצר	יוירעש־עצער
יורשטע	יוירעשטע
יורשים	יאָרשים
יושבֿ	יוישעוו
יושבֿ־אוהל	יוישעוו־אויעל
יושבֿ־ראָש	יוישעוו־ראָש
יושבֿי־אוהל	יאָשווע־אויעל
יושבֿים	יאָשווים
יושר	יוישער
יזכּור	ייִסקער
יזכּור־בוך	ייִסקער־בוך
יזרעאל	איזרעעל
יזרעאלן	איזרעעלן
יזרעאלס	איזרעעלס
יחדיו	יאַכדעוו
יחזקאל	יעכעסקל
יחזקאלן	יעכעסקלען
יחזקאלס	יעכעסקלס
יחיאל	יעכיִעל
יחיד	יאָכעד
יחיד־בדור	יאָכעד־בעדאָר
יחיד־במינו	יאָכעד־בעמינע
יחידי־סגולה	יעכידע־זגולע
יחידים	יעכידים
יחיה	ייִכיע
יחלוקו	יאַכאַלויקו
יחסן	יאַכסן
יחסנות	יאַכסאָנעס
יחסנטע	יאַכסנטע
יחסנים	יאַכסאָנים
יחסנען	יאַכסענען
ייִאוש	יייעש,ייִעש
ייִחוד	ייִכעד
ייִחודים	ייִכודים
ייִחוס	ייִכעס
ייִחוס־בריוו	ייִכעס־בריוו
ייִחוס־עצמו	ייִכעס־אַצמע
ייִחוסן	ייִכעסן
יין	יאַיִן
יין־המשומר	יאַיִן־האַמשומער
יין־נסך	יאַיִן־נעסעך
יין־קפֿריסין	יאַיִן־קאַפֿריסן
יין־שׂרף	יאַיִן־סאָרעף
ייִראה	ייִרע
ייִראת־הכּבֿוד	ייִרעס־האַקאָוועד
ייִראת־השם	ייִרעס־האַשעם
ייִראת־שמים	ייִרעס־שאָמאַיִם
ייִשובֿ	ייִשעוו
ייִשובֿ־הדעת	ייִשעוו־האַדאַאַס
ייִשובֿים	ייִשוּווים
ייִשובֿן	ייִשעוון
ייִשובֿניצע	ייִשוּווניצע
ייִשובֿניק	ייִשוּווניק
יישר־כּוח	יאַשער־קויעך,שקויעך
ייִתּור	ייִטער
ייִתּוש	ייִטעש
ייִתּושים	ייִטושים
יכּכּה	יאַקעקאָ
יכול	יאָכל
יכולט	יאָכלט
יכולסט	יאָכלסט
יכולסטו	יאָכלסטו
יכולען	יאָכלען
יכולת	יעכוילעס
יכל	יאָכל
יכלט	יאָכלט
יכלסט	יאָכלסט
יכלסטו	יאָכלסטו
יכלען	יאָכלען
ילד	יעלעד
ילד־שעשועים	יעלעד־שאַאַשויִם
ילדים	יעלאָדים
ילוד־אישה	יעלוד־אישע
יללה	יעלאָלע
ילמדנו	יעלאַמדיינע
ילקוט	יאַלקעט
ילקוטים	יאַלקוטים
ים	יאַם
ים של שלמה	יאַם שעל שלוימע
ים־אוקינוס	יאַם־אָקיאָנעס
ים־הגדול	יאַם־האַגאָדל
ים־המלח	יאַם־האַמעלאַך
ים־הקרוש	יאַם־האַקאָרעש
ים־הקרח	יאַם־האַקעראַך
ים־התּיכון	יאַם־האַטיכוין
ים־חזירימלעך	יאַם־כאַזיירימלעך
ים־חזירל	יאַמכאַזערל
ים־סוף	יאַמסוף
ימח־שמו	ייִמאַך־שמוי,ייִמאַך־שעמוי
ימח־שמו־וזכרו	ייִמאַך־שמוי־וועזיכרוי
ימח־שמוניצע	ייִמאַכשמויניצע
ימח־שמוניק	ייִמאַכשמויניק
ימח־שמם	ייִמאַך־שמאָם,ייִמאַך־שעמאָם
ימח־שמם־וזכרם	ייִמאַך־שמאָם־וועזיכראָם,ייִמאַך־שעמאָם־וועזיכראָם
ימי־	יעמיי
ימים	יאָמים
ימים־ומידבריות	יאַמים־אומידבאָריעס
ימים־ושנים	יאָמים־וועשאָנים
ימים־טובֿים	יאָמים־טויווים
ימים־נוראָים	יאָמים־נעראָיִם
ימים־נוראָימדיק	יאָמים־נעראָיִמדיק
ימען	יאַמען
ינוקא	יענוקע
יניקה	יעניקע
יסוד	יעסאָד
יסודות	יעסוידעס
יסורים	יעסורים
יסורים־רעים	יעסורים־ראָיִם
יסורים־של־אַהבֿה	יעסורים־שעל־אַאַווע,יעסורים־שעל־אַהאַווע
יעבֿור עלי מה	יײַווער אָלײַ מאָ
יעלה	יײַלע
יעלה־ויבֿא	יײַלע־וועיאָווע
יעמוד	יאַאַמויד
יעקבֿ	יאַנקעוו
יעקבֿ אָבֿינו	יאַנקעוו אָווינו
יעקבֿ אָבֿינוס	יאַנקעוו אָווינוס
יעקבֿן	יאַנקעוון
יעקבֿס	יאַנקעווס
יפֿהפֿיה	יעפֿייפֿיִע,יעפֿייפֿע
יפֿתּח	ייִפֿטאַך
יפֿת	יעפֿעס
יפֿת־תּואר	יעפֿאַסטויער
יצא־מדעתּו	יאָצע־מידאַטע
יצחק	ייִצכאָק
יצחק אָבֿינו	ייִצכאָק אָווינו
יצחק אָבֿינוס	ייִצכאָק אָווינוס
יצחקי	ייִצכאָקי
יצחקן	ייִצכאָקן
יצחקס	ייִצכאָקס
יציאת־הנפֿש	יעציִעס־האַנעפֿעש
יציאת־מצרים	יעציִעס־מיצראַיִם
יציאת־נשמה	יעציִעס־נעשאָמע
יצירה	יעצירע
יצירות	יעצירעס
יצר־הרע	יייצער־האָרע
יצר־טובֿ	יייצער־טאָוו,יייצער־־טויוו
יקום־פּורקן	יעקום־פּורקאָן,יעקום־פּורקן
יקותיאל	יעקוסיִעל
יקיר	יאַקיר
יקירי	יעקירי
יקנה״ז	יאַקנעהאָז
יקר־המציאות	יעקאַר־האַמציִעס
יקרות	יאַקרעס
יקרן	יאַקרען
יקרנים	יאַקראָנים
ירא־חטא	יאָרע־כעט,ייִרע־כעט
ירא־שמים	יאָרע־שאָמאַיִם
יראי־שמים	ייִרע־שאָמאַיִם
ירבֿעם בן־נבֿט	יעראָוואָם בען־נעוואָט
ירגזון	ייִרגאָזן
ירדן	יאַרדן
ירוחם	יערוכעם
ירוחמס	יערוכעמס
ירוחמען	יערוכעמען
ירום־הודו	יאָרעם־הוידע
ירושה	יערושע
ירושות	יערושעס
ירושלים	יערושאָלאַיִם
ירושלים־ד…	יערושאָלאַיִם־דע
ירושלים־דליטא	יערושאָלאַיִם־דעליטע
ירושלמי	יערושאַלמי
ירחמיאל	יעראַכמיִעל
ירחמיאלן	יעראַכמיִעלן
ירחמיאלס	יעראַכמיִעלס
יריד	יאַריד,יעריד
ירידה	יערידע
ירידן	יאַרידן
יריחו	יעריכע
יריחוס	יעריכעס
יריעה	יעריִע
יריעות	יעריִעס
ירמיהו	ייִרמיאָהו,ייִרמיִע
ירמיהון	ייִרמיאָהון,ייִרמיִען
ירמיהוס	ייִרמיאָהוס,ייִרמיִעס
ירשען	יאַרשען
ירשענען	יאַרשענען
יש	יאַש,יעש
י״ש	יאַש
יש אומרים	יעש אָמרים
יש־אומרים	יעש־אָמרים
יש־מאַין	יעש־מעאַיִן
ישו	ייישו,ייִשו
ישו הנוצרי	ייישו האַנויצרי,ייִשו האַנויצרי
ישו הנוצריס	ייישו האַנויצריס
ישועה	יעשוע
ישועות	יעשועס
ישועות־ונחמות	יעשועס־ווענעכאָמעס
ישיבֿה	יעשיווע
ישיבֿות	יעשיוועס
ישיש	יאָשעש
ישישים	יעשישים
ישמעאל	ייִשמאָעל
ישן־נושן	יאָשן־נוישן
ישעיה	יעשײַע
ישעיהו	יעשאַיאָהו
ישעיהו הנבֿיא	יעשאַיאָהו האַנאָווע
ישעיהו הנבֿיאס	יעשאַיאָהו האַנאָוועס
ישקני	ייִשאָקייני
ישר	יאָשער
ישרן	יאַשרען
ישרנות	יאַשראָנעס
ישרנים	יאַשראָנים
ישׂראל	ייִסראָעל
ישׂראלי	ייִסראָיילי
ישׂראלית	ייִסרעייליס
ישׂראלן	ייִסראָעלן
ישׂראלס	ייִסראָעלס
ישׂשׂכר	ייִסאָכער,ייִסאָסכער
יתום	יאָסעם
יתומדיק	יאָסעמדיק
יתומה	יעסוימע
יתומים	יעסוימים
יתומימדיק	יעסוימימדיק
יתומימדיקן	יעסוימימדיקן
יתומימדיקס	יעסוימימדיקס
יתומימדיקע	יעסוימימדיקע
יתומימדיקער	יעסוימימדיקער
יתרו	ייִסרע
יתרון	ייִסרען
יתרונות	ייִסרוינעס
כּ	קאָף
כּ…	קע…
כּאור	קאַיאָר,קעאָר
כּאור־הבוקר	קעאָר־האַבויקער
כּאחד־האָדם	קעעכאָד־האָאָדעם
כּאחד־הריקים	קעעכאָד־האָרייקים
כּאילו	קעיִלע
כּאַן בוכין	קאַן בויכן
כּבֿד־לשון	קוואַד־לאָשן
כּבֿד־פּה	קוואַטפּע
כּבֿוד	קאָוועד
כּבֿוד־	קוואָד
כּבֿוד־הרבֿ	קוואָד־האַראַוו
כּבֿיכול	קאַוויאָכל
כּדאַי	קעדײַ
כּדאַיִק	קעדאַיִק
כּדבעי	קעדעבאָע
כּדומה	קעדוימע
כּדומה־למשל	קעדוימע־לעמאָשל
כּדור־האָרץ	קאַדער־האָאָרעץ
כּדי	קעדיי
כּדין	קעדין
כּדין־וכּדת	קעדין־אוקעדאַס,קעדין־וועקעדאַס
כּדרכּה	קעדאַרקע
כּדרכּו	קעדאַרקע
כּדרך־הטבֿע	קעדערעך־האַטעווע
כּדת	קעדאַס
כּדת־משה־וישׂראל	קעדאַס־מוישע־וויסראָעל
כּהאַי־לישנא	קעהײַ־לישנע
כּהוויה	קעהאַווײַע
כּהונה	קעהונע
כּהלכה	קעהאַלאָכע
כּהן	קויען
כּהן־גדול	קויען־גאָדל
כּהנא־וכהנא	קאָהיינע־וועכאָהיינע
כּהנדיק	קויענדיק
כּהנים	קאָיאַנים,קעהאַנים
כּהנים־גדולים	קאָיאַנים־גדוילים
כּהרף־עין	קערעף־אַיִן
כּוונה	קאַוואָנע
כּוונות	קאַוואָנעס
כּוזרי	קוזרי
כּוזרים	קוזרים
כּוח	קויעך
כּוח־גבֿרא	קויעך־גאַוורע
כּוח־הדיבור	קויעך־האַדיבער
כּוח־הדם	קויעך־האַדאַם
כּוח־הדמיון	קויעך־האַדימיען
כּוח־המדמה	קויעך־האַמעדאַמע
כּוח־המושך	קויעך־האַמוישעך
כּוח־הרשאה	קויעך־האַרשאָע
כּוחות	קויכעס
כּוחן	קויעכן
כּוכבֿים־ומזלות	קויכאָווים־אומאַזאָלעס
כּולה תּורה	קולע טוירע
כּולו	קולע
כּולו זכּאי	קולע זאַקע
כּולו חייבֿ	קולע כײַעוו
כּולו מוקשה	קולע מוקשע
כּולו רווח	קולע רעוועך
כּולי האַי	קולע הײַ
כּולל	קוילעל
כּוללים	קאָלעלים
כּולם	קולעם
כּומר	קוימער
כּומרים	קאָמרים
כּוס	קאָס
כּוסות	קויסעס
כּוסיע	קויסע
כּוסיעס	קויסעס
כּוסע	קויסע
כּוסען	קויסען
כּוסענען	קויסענען
כּוסעס	קויסעס
כּופֿר	קויפֿער
כּופֿר־בעיקר	קויפֿער־בעיִקער
כּופֿר־הכּל	קויפֿער־האַקל
כּופֿרים	קאָפֿרים
כּופֿרים־בעיקר	קאָפֿרים־בעיִקער
כּורעים	קוירים
כּורעים־ומשתּחווים	קוירים־אומישטאַכווים
כּורש	קוירעש
כּורת־ברית	קוירעס־בריס
כּוש	קוש
כּותל־מערבֿי	קויסל־מאַראָווי
כּזבֿ	קאָזעוו,קעזעוו
כּזבֿ־ושקר	קאָזעוו־וועשעקער
כּזבֿים	קזאָווים
כּזבֿן	קאַזוון
כּזבֿנטע	קאַזוונטע
כּזבֿנטעס	קאַזוונטעס
כּזבֿנים	קאַזוואָנים
כּזית	קעזאַיִס
כּזיתים	קעזייסים
כּחוט־השׂערה	קעכוט־האַסיירע
כּחול־הים	קעכויל־האַיאַם
כּחומר ביד־היוצר	קעכוימער בעיאַד־האַיויצער
כּחצות־הלילה	קעכצאָס־האַלײַלע
כּחרס־הנישבר	קעכערעס־האַנישבער
כּי־הוא־זה	קי־הו־זע
כּי־תבֿוא	קי־סאָוואָ
כּי־תישׂא	קי־סיסאָ
כּי־תצא	קי־סייצע
כּיאור	קאַיאָר
כּיבוד	קיבעד
כּיבוד־אָבֿ	קיבעד־אָוו
כּיבוד־אם	קיבעד־איים
כּיבודים	קיבודים
כּיד־הגבֿיר	קעיאַד־האַגוויר
כּיד־המלך	קעיאַד־האַמיילעך
כּידוע	קעיעדוע
כּיוון	קיוון
כּיור	קיִער
כּיזובֿ	קיזעוו
כּיזובֿים	קיזוּווים
כּיכּר־לחם	קיקער־לעכעם
כּילאַים	קילאַיִם
כּינה	קינע
כּינים	קינים
כּיס	קיס
כּיסא־הכּבֿוד	קיסע־האַקאָוועד
כּיסא־המלכות	קיסע־האַמאַלכעס
כּיסא־הרבנות	קיסע־האַראַבאָנעס
כּיסא־הרחמים	קיסע־האַראַכמים
כּיסא־רבנות	קיסע־ראַבאָנעס
כּיסא־של־אליהו	קיסע־שעל־עליאָהו
כּיסא־של־אליהו הנבֿיא	קיסע־שעל־עליאָהו האַנאָווי
כּיסים	קיסים
כּיסלו	קיסלעוו
כּיסלער	קיסלער
כּישוף	קישעף
כּישופֿים	קישופֿים
כּישופֿן	קישעפֿן
כּישרון	קישרען
כּישרונות	קישרוינעס
כּיתּה	קיטע
כּיתּות	קיטעס
כּיתבֿי־הקודש	קיסווע־האַקוידעש
כּכּתובֿ	קאַקאָסעוו
כּך־הווה	קאַך־האַווע
כּך־היה	קאַך־הויע
כּך־וכּך	קאַך־וועקאַך
כּל הקודם זכה	קאָל האַקוידעם זאָכע
כּל ישׂראל חבֿרים	קאָל ייִסראָעל כאַוויירים
כּל מאמינים שהוא	קאָל מאַמינים שעהו
כּל עורבֿ למינהו	קאָל אוירעוו לעמינייהע
כּל־	קאָל
כּל־בו	קאָלבוי
כּל־בוניצע	קאָלבויניצע
כּל־בוניק	קאָלבויניק
כּל־דבֿר־אָסור	קאָל־דאָווער־אָסער
כּל־דבֿר־שורש	קאָל־דוואַר־שוירעש
כּל־דכפֿין	קאָל־דיכפֿין
כּל־ה…	קאָל־האַ…
כּל־הון־דעלמא	קאָל־האָן־דעאַלמע,קאָל־הוין־דעאַלמע
כּל־הטעמים	קאָל־האַטײַמים
כּל־המינים	קאָלאַמינים
כּל־הפּסלנות	קאָל־האַפּאַסלאָנעס
כּל־הפּסלנות־שבעולם	קאָל־האַפּאַסלאָנעס־שעבאָוילעם
כּל־השבֿועות	קאָל־האַשוווּעס
כּל־השבֿועות־שבעולם	קאָל־האַשוווּעס־שעבאָוילעם
כּל־התּועבֿות	קאָל־האַטויעוועס
כּל־התּורה־כּולה	קאָל־האַטוירע־קולע
כּל־ולך	קאָלוועלאָך
כּל־ולכטע	קאָלוועלאָכטע
כּל־זמן	קאָלזמאַן
כּל־זמן שהנשמה בקירבי	קאָלזמאַן שעהאַנעשאָמע בעקירבי,קאָלזמאַן שעהאַנשאָמע בעקירבי
כּל־חמתה	קאָל־כאַמאָסע
כּל־חמתו	קאָל־כאַמאָסאָ
כּל־חמתם	קאָל־כאַמאָסאָם
כּל־טובֿ	קאָל־טוּוו
כּל־יכול	קאָל־יאָכל
כּל־ימי	קאָל־יאָמײַ
כּל־ימיהם	קאָל־יעמייהעם
כּל־ימיו	קאָל־יאָמעוו
כּל־ישׂראל	קאָל־ייִסראָעל
כּל־מיני	קאָל־מינע
כּל־נדרי	קאָלנידרע
כּל־עבֿודות־זרות־שבעולם	קאָל־אַוווידעזאָרעס־שעבאָוילעם
כּל־שורש־דבֿר	קאָל־שוירעש־דאָווער
כּל־שכּן	קאָלשקיין
כּל־תּפֿוצות־ישׂראל	קאָל־טפֿוצעס־ייִסראָעל
כּלא־היה	קעלוי־הויע
כּלא־ידע	קילעיאָדע
כּלאַחר־יד	קילאַכער־יאַד
כּלבֿ	קעלעוו
כּלבֿ־שבכּלבֿים	קעלעוו־שעבאַקלאָווים
כּלבֿטע	קלאַווטע,קלאַפֿטע
כּלבֿטעס	קלאַווטעס,קלאַפֿטעס
כּלבֿים	קלאָווים
כּלה	קאַלע
כּלה־מויד	קאַלע־מויד
כּלהס	קאַלעס
כּלו כּל הקיצין	קאָלו קאָל האַקיצן
כּלומר	קלוימער
כּלומרשט	קלוימערשט
כּלות־הנפֿש	קעלאָס־האַנעפֿעש
כּלחוך־השור	קילכויך־האַשאָר
כּלי	קיילע
כּלי־בית	קלע־באַיִס
כּלי־זהבֿ	קלע־זאָהאָוו
כּלי־זיין	קלע־זאַיִן
כּלי־זמר	קלעזמער
כּלי־זמרײַ	קלעזמערײַ
כּלי־זמרים	קלעזמאָרים
כּלי־זמרין	קלעזמערן
כּלי־יקר	קלע־יאָקער
כּלי־כּסף	קלע־קעסעף
כּלי־כּתיבֿה	קלע־קסיווע
כּלי־מפֿואר	קלימעפֿויער
כּלי־משחית	קלע־מאַשכיס
כּלי־נפֿלאה	קיילע־ניפֿלאָע
כּלי־קודש	קלע־קוידעש
כּלי־שלמה	קיילע־שליימע
כּלי־שני	קיילע־שיינע
כּלים	קיילים
כּלל	קלאַל
כּלל־זאַך	קלאַל־זאַך
כּלל־זאַכן	קלאַל־זאַכן
כּלל־טוער	קלאַל־טוער
כּלל־טוערס	קלאַל־טוערס
כּלל־ייִדיש	קלאַל־ייִדיש
כּלל־ישׂראל	קלאַל־ייִסראָעל
כּלל־ענינים	קלאַל־איניאָנים
כּלל־שפּראַך	קלאַל־שפּראַך
כּלל־שפּראַכן	קלאַל־שפּראַכן
כּלליות	קלאַליִעס
כּללים	קלאָלים
כּלערליי	קאָלערליי
כּלפּי	קלאַפּע
כּלפּי־חוץ	קלאַפּע־כוץ
כּלפּי־פּנים	קלאַפּע־פּנים
כּמה	קאַמע
כּמה־וכּמה	קאַמע־וועקאַמע
כּמה־וכּמה טעמים	קאַמע־וועקאַמע טײַמים
כּמו	קמוי
כּמובֿן	קעמוּוון
כּמובֿן־מאליו	קעמוּוון־מעיילעוו
כּמות	קאַמעס
כּמינהגה	קעמינהאָגע
כּמינהגו	קעמינהאָגע
כּמלך־בגדוד	קעמיילעך־ביגדוד
כּמעט	קימאַט
כּמקדם	קעמיקעדעם
כּן־יאָבֿדו	קען־יאָוודו
כּן־ירבו	קען־ייִרבו
כּנגד	קענעגעד
כּנגדים	קענעגדים
כּנהוג	קינהאָג,קענאָהעג
כּנופֿיא	קנופֿיע
כּנופֿיה	קנופֿיע
כּניזכּר לעיל	קעניסקער לעייל
כּנ״ל	קאַנאַל
כּנסתּ	קנעסעט
כּנסת־הגדולה	קנעסעס־האַגדוילע
כּנסת־ישׂראל	קנעסעס־ייִסראָעל
כּנען	קנאַאַן
כּסדר	קעסיידער
כּסף	קעסעף
כּסף־טהור	קעסעף־טאָהער
כּעל־כּף־היד	קעאַל־קאַף־האַיאַד
כּעלות	קאַאַלאָס
כּעלות־הבוקר	קאַאַלאָס־האַבויקער
כּעלות־השחר	קאַאַלאָס־האַשאַכער
כּעני־בפּתח	קעאָני־באַפּעסעך
כּעס	קאַאַס
כּעס־וחמה	קאַאַס־וועכיימע
כּעסן	קײַסן
כּעסנטע	קײַסנטע
כּעסנים	קײַסאָנים
כּעסנען	קײַסענען
כּעפֿרא־דאַרעא	קעאַפֿרע־דעאַרע
כּפּרה	קאַפּאָרע
כּפּרה־הינדל	קאַפּאָרע־הינדל
כּפּרהניצע	קאַפּאָרעניצע
כּפּרהניצעס	קאַפּאָרעניצעס
כּפּרות	קאַפּאָרעס
כּפּשוטו	קעפּשוטע
כּף	קאָף
כּף־הקל	קאַפֿאַקאַל,קאַפֿאַקל
כּף־הקלע	קאַף־האַקעלע
כּפֿוי־טובֿה	קאָפֿע־טויווע,קפֿוּיע־טויווע
כּפֿוי־טובֿהניק	קאָפֿע־טויוועניק
כּפֿול־שמונה	קאָפֿל־שמוינע
כּפֿול־שמונהדיק	קאָפֿל־שמוינעדיק
כּפֿי	קעפֿי
כּפֿירה	קפֿירע
כּפֿל	קייפֿל
כּפֿל־כּפֿלים	קייפֿל־קעפֿלאַיִם
כּפֿלען	קייפֿלען
כּפֿתּורן	קאַפֿטערן
כּצאן־בלי־רועה	קעצוין־בלי־רויע,קעצוין־בעלי־רויע
כּצפּיחית־בדבֿש	קעצאַפּיכעס־בידוואָש
כּקליפּת־השום	קעקליפּעס־האַשום
כּקריעת־ים־סוף	קעקריִעס־יאַמסוף
כּרובֿ	קרוּוו
כּרוז	קרוז
כּרחוק־מיזרח־ממערבֿ	קירכויק־מיזרעך־מימײַרעוו
כּרים־וכּסתות	קאָרים־אוקסאָסעס
כּריתות	קאָרייסעס
כּרך	קערעך,קראַך
כּרכים	קראָכים
כּרעיה־דאַבוהדיק	קרײַע־דאַבועדיק
כּרפּס	קאַרפּעס
כּרת	קאָרעס
כּשורה	קעשורע
כּשל־ברך	קשאַל־בערעך
כּשר	קאָשער
כּשר־וישר	קאָשער־וועיאָשער
כּשר־טאַנץ	קאָשערטאַנץ
כּשר־לפּסח	קאָשער־לעפּייסעך
כּשרות	קאַשרעס
כּשרים	קשיירים
כּשרן	קאָשערן,קאַשערן
כּשרס	קאָשערס
כּשרע	קאָשערע
כּשרער	קאָשערער
כּתּ	קאַט
כּתּ־דיליה	קאַט־דיליי
כּתּ־ליצנים	קאַט־לייצאָנים
כּתּבֿות	קאַטאָוועס
כּתבֿ	קסאַוו
כּתבֿ־יד	קסאַוויאַד
כּתבֿ־ידן	קסאַוויאַדן
כּתבֿ־פּלסתּר	קסאַוו־פּלאַסטער
כּתבֿ־רבנות	קסאַוו־ראַבאָנעס
כּתבֿא־רבא	קאַסווע־ראַבע
כּתבֿי־יד	קיסווע־יאַד
כּתבֿי־פּלסתּר	קיסווע־פּלאַסטער
כּתבֿים	קסאָווים
כּתבֿען	קאַסווען
כּתבֿענען	קאַסווענען
כּתובה	קסובע
כּתובות	קסובעס
כּתובֿ־וחתום	קאָסעוו־וועכאָסעם
כּתובֿים	קסוּווים
כּתיבֿ	קסיוו
כּתיבֿה	קסיווע
כּתיבֿה וחתימה טובֿה	קסיווע וועכסימע טויווע
כּתיבֿהן	קסיווען
כּתיבֿיש	קסיוויש
כּתר	קעסער
כּתריאל	קאַסריל,קאַסריִעל
כּתריאליק	קאַסריליק
כּתריאלעווקע	קאַסרילעווקע
כּתריאלעווקער	קאַסרילעווקער
כּתריליק	קאַסריליק
כּתרילעווקע	קאַסרילעווקע
כּתרילעווקער	קאַסרילעווקער
כּתרים	קסאָרים
כף	כאָף
ל…	לאַ…,לי…,לע…
ל	לאַמעד
לא	לוי
לא אַלמן ישׂראל	לוי אַלמען ייִסראָעל
לא דובים ולא יער	לוי דובים וועלוי יאַאַר
לא הוכשר דרא	לוי הוכשער דאָרע
לא היה ולא ניבֿרא	לוי הויע וועלוי ניוורע
לא היו דבֿרים מעולם	לוי הויו דוואָרים מעוילעם
לא יזכר ולא יפּקד	לוי ייִזאָכער וועלוי ייִפּאָקעד
לא ימלט	לוי ייִמאָלעט
לא פֿיללתּי	לוי פֿילאָלטי
לא־די	לוי־דײַ
לא־יוצלח	לוי־יוצלעך
לא־יחרץ	לוי־יעכרעץ
לא־יחרץ־געלט	לוי־יעכרעץ־געלט
לא־כּי	לויקי
לא־כּל־שכּן	לוי־קאָלשעקען,לוי־קאָלשקען
לא־עליכם	לוי־אַלייכעם
לא־עליכמדיק	לוי־אַלייכעמדיק
לא־עלינו	לוי־אָליינו
לא־פֿידלתּי	לויפֿידאַלטי
לא־תחמוד	לוי־סאַכמעד
לא־תיגנובֿ	לוי־סיגנעוו
לא־תינאף	לוי־סינעף
לא־תירצח	לוי־סירצעך,לוי־־סערצעך
לא־תעשׂה	לויסײַסע,לויסעסע
לאה	לייע
לאהלע	לייעלע
לאהלען	לייעלען
לאהלעס	לייעלעס
לאהן	לייען
לאהס	לייעס
לאַוו	לאַוו
לאַוו־דווקא	לאַוו־דאַפֿקע
לאַחדים	לאַכאָדים
לאַחדימניצע	לאַכאָדימניצע
לאַחדימניצעס	לאַכאָדימניצעס
לאַחדימניק	לאַכאָדימניק
לאַחדימניקעס	לאַכאָדימניקעס
לאַחר־המעשׂה	לעאַכער־האַמײַסע
לאַחר־זמן	לעאַכער־זמאַן
לאַחר־מאה־שנים	לעאַכער־מייע־שאָנים
לאיבוד	לעיִבעד
לאמר	ליימער
לאמרן	ליימערן
לאַפֿוקי	לאַפֿוקע
לבריאת־העולם	ליבריִעס־האָוילעם
לבריאת־עולם	ליבריִעס־אוילעם
לבֿ	לעוו
לבֿ יודע	לעוו יעדייע
לבֿ־טובֿ	לעווטאָוו,לעפֿטאָוו
לבֿבֿות	לעוואָוועס
לבֿוש	לעוווּש
לבֿושים	לעוווּשים
לבֿושין	לעוווּשן
לבֿטלה	לעוואַטאָלע
לבֿן	לאָוון
לבֿן האַרמי	לאָוון האָאַראַמי
לבֿנה	לעוואָנע
לבֿנון	לעוואָנען
לבֿנות	לעוואָנעס
ל״ג־בעומר	לאַג־בעוימער,לעגבוימער
לגבי	לעגאַבע
לגמרי	לעגאַמרע
לגנאַי	ליגנײַ
לדוגמא	לעדוגמע
לדור־דורות	לעדאָר־דוירעס
לדורות	לעדוירעס
להבא	לעהאַבע
להבֿדיל	לעהאַוודל
להבֿדיל אלף אַלפֿי הבֿדלות	לעהאַוודל עלעף אַלפֿיי האַוודאָלעס
להבֿדיל אלף הבֿדלות	לעהאַוודל עלעף האַוודאָלעס
להד״ם	לעהאַדאַם
להוט	לאָעט,לאָער
להיפּוך	לעהייפּעך
להכעיס	לעהאַכעס
להכעיסניצע	לעהאַכעסניצע
להכעיסניק	לעהאַכעסניק
להרוג־ולאַבד	לאַהאַרעג־אולעאַבעד
להשמיד־ולהרוג	לעהאַשמיד־אולעהאַרעג
לווה	לויווע
לווי	לייווי
לוויה	לעווײַע
לוויות	לעווײַעס
לוויים	לעוויִיִם
לווים	לויווים
לוויתן	לעוויאָסן
לוח	לועך
לוחות	לוכעס
לוט	לאָט,לויט
לולבֿ	לולעוו
לולבֿים	לולאָווים
לומדות	לאָמדעס
לומדים	לאָמדים
לומדיש	לאָמדיש
לומרן	לוימערן
לועג־לרש	לויעג־לעראָש
לוריא	לוריע
לזכּרון	לעזיקאָרן
לזכות	ליסכוס
לזכר	לעזייכער
לזכר־עולם	לעזייכער־אוילעם
לזכרון־דורות	לעזיכרען־דוירעס
לחובֿה	לעכויווע
לחוד	לעכוד
לחות	לייכעס,לייכעץ
לחיים	לעכאַיִם
לחיים־ולשלום	לעכאַיִם־אולעשאָלעם
לחיים־טובֿים־ולשלום	לעכאַיִם־טויווים־אולעשאָלעם
לחלוטין	לאַכלוטן
לחם	לעכעם
לחמא	לאַכמע
לחצאָים	לאַכאַצאָיִם
לחצאָין	לאַכאַצאָיִן
לחש	לאַכעש
לחשים	לעכאָשים
לטובֿה	לעטויווע
לטובֿת	לעטויוועס
לטובֿת־הכּלל	לעטויוועס־האַקלאַל
לידי גמר	לידיי גמאַר,לידיי געמער
ליהודים	לאַיעהודים
ליל־השימורים	לייל־האַשימורים
ליל־שימורים	לייל־שימורים
לילית	ליליס
לימוד	לימעד
לימודים	לימודים
לינת־הצדק	לינעס־האַצעדעק
לינת־צדק	לינעס־צעדעק
ליקוי	ליקע
ליקוי־חמה	ליקע־כאַמע
ליקוי־לבֿנה	ליקע־לעוואָנע
ליקויים	ליקויִם
לית ברירה	לעס בריירע
לית דין ולית דיין	לעס דין וועלעס דײַען
ליתר־בטחון	לעיעסער־ביטאָכן
ליתר־חיזוק	לעיעסער־כיזעק
ליתר־תּוקף	לעיעסער־טויקעף
לכּבֿוד	לעקאָוועד
לכּל עת	לאַקל אייס
לכּף־זכות	לעקאַף־סכוס
לכּף־חובֿ	לעקאַף־כויוו
לכּשירוויח	ליקשעיאַרוויִעך
לכּשירחיבֿ	ליקשעיאַרכעוו
לך־לך	לעכלעכאָ
לכאורה	ליכוירע
לכבֿוד	ליכווויד
לכה־דודי	לעכאָ־דוידי
לכו ונלכה	לעכו וועניילכאָ
לכו־נרננה	לעכו־נעראַנענאָ
לכל־הדעות	לעכאָלאַדייעס
לכל־הפּחות	לעכאָלאַפּאָכעס
לכן	לאָכיין,לאָכן
לכשירוויח	ליכשעיאַרוויִעך
לכשירחיבֿ	ליכשעיאַרכעוו
לכתּחילה	לעכאַטכילע
ללעג־ולקלס	לעלאַאַג־אולקעלעס
למאַי	לעמײַ
למד	לאַמעד
למד־וואָוו	לאַמעדוואָוו
למד־וואָווניצע	לאַמעד־וואָווניצע
למד־וואָווניק	לאַמעד־וואָווניק
למדינת־הים	לימדינעס־האַיאַם
למדן	לאַמדן
למדנות	לאַמדאָנעס
למדנים	לאַמדאָנים
למהדרין	לעמעהאַדרין
למזל	לעמאַזל
למיספּרם	לעמיספּאָראָם
למך	לעמעך
למעלה	לעמײַלע
למעלה־מן־הטבֿע	לעמײַלע־מין־האַטעווע
למעלה־מן־השׂכל	לעמײַלע־מין־האַסייכל
למען־האמת	לעמאַן־האָעמעס
למען־השם	לעמאַנאַשעם
למען־ידעו	לעמאַן־ייידו
למען־ישמעו־ויראו	לעמאַן־ייִשמעו־וועייִרו
למעשׂה	לעמײַסע
למראית־עין	לעמאַרעס־אַיִן
למשל	לעמאָשל
לנוי	לענוי
לסוף	לעסאָף
לסירוגין	לעסיירוגן
לעבֿר־הים	לעייווער־האַיאַם
לעולם	לעוילעם
לעולם תּיקח	לעוילעם טיקעך
לעולם־ועד	לעוילעם־וואָעד
לעולמות	לעוילאָמעס,לעוילעמעס
לעזאזל	לאַזאָזל
לעילא־ולעילא	ליילע־אוליילע
לעילא־ולעילאדיק	ליילע־אוליילעדיק
לעיני־השמש	לעיינע־האַשעמעש
לעניננו	לעיִניאָניינו
לערך	לעערעך
לעת־זיקנה	לעייס־זיקנע
לעת־עתּה	לעסאַטע
לעתיד	לעאָסעד
לעתיד־לבֿוא	לעאָסעד־לאָווע
לפּ״ג	לאַפּאַג
לפּחות	לעפּאָכעס
לפּנים	לעפּאָנעם
לפּ״ק	לאַפּאַק
לפּרט־גדול	ליפּראַט־גאָדל
לפּרט־קטן	ליפּראַט־קאָטן
לפֿי	לעפֿי
לפֿי־דעתּי	לעפֿידאַטי
לפֿי־זה	לעפֿיזע
לפֿי־מעשׂיו	לעפֿי־מײַסעוו
לפֿי־ערך	לעפֿי־ערעך
לפֿי־שעה	לעפֿישאָ
לפֿי־שעהדיק	לעפֿי־שאָעדיק
לפֿי־תּומו	לעפֿי־טומע
לפֿני־ולפֿנים	ליפֿנײַ־וועליפֿנים
לפֿני־כּל־עם־ועדה	ליפֿניי־קאָל־אַם־וועיידע
לפֿנים־משורת־הדין	ליפֿנים־מעשורעס־האַדין
לץ	לעץ
לצון	לאָצן
לצים	לייצים
לצמיתות	ליצמיסעס
לצן	לעצן
לצנות	לעצאָנעס
לצנים	לעצאָנים
לצעווען	לעצעווען
לקחן	לאַטכן,לאַקכן
לקחנים	לאַטכאָנים,לאַקכאָנים
לקחנען	לאַטכענען,לאַקכענען
לרובֿ	לעראָוו
לרעה	לעראָע
לרצון	לעראָצן
לשבֿח	לישוואַך
לשון	לאָשן
לשון־הרע	לאָשן־האָרע
לשון־זכר	לאָשן־זאָכער
לשון־יחיד	לאָשן־יאָכעד
לשון־נקבֿה	לאָשן־נעקייווע
לשון־נקיה	לאָשן־נעקיִע
לשון־סגי־נהור	לאָשן־סעגינאָער
לשון־קודש	לאָשן־קוידעש
לשון־רבים	לאָשן־ראַבים
לשונות	לעשוינעס
לשיטתו	לעשיטאָסע
לשם	לעשעם
לשם־ייִחוד	לעשעם־ייִכעד
לשם־שמים	לעשעם־שאָמאַיִם
לשמה	לישמאָ
לשנה הבאה בירושלים	לעשאָנאָ האַבאָ בירושאָלאַיִם
לשנה טובֿה תּכּתבֿו	לעשאָנע טויווע טיקאָסייוווּ
לשנה טובֿה תּכּתבֿו ותחתמו	לעשאָנע טויווע טיקאָסייוווּ וועסעכאָסיימו
לתּורה לחופּה ולמעשׂים־טובֿים	לעטוירע לעכופּע אולמײַסים־טויווים
לתּרבות־רעה	לעטאַרבעס־ראָע
לתּשמיש	לעטאַשמעש
מ…	מי…,מע…
מ	מעם
מאַבד	מעאַבעד
מאַבד־ממון	מעאַבעד־מאָמען
מאַבד־עצמו־לדעת	מעאַבעד־אַצמע־לאַדאַאַס
מאדים	מײַדעם
מאה	מייע
מאַהבֿה	מעאַאַווע,מעאַהאַווע
מאַהבֿת־	מעאַאַוועס,מעאַהאַוועס
מאַהבֿת־מרדכי	מעאַאַוועס־מאָרטכע,מעאַהאַוועס־מאָרטכע
מאוימדיק	מעוּיעמדיק
מאָוס	מאָעס
מאור	מאָער
מאור־הגולה	מאָער־האַגוילע
מאות	מייעס
מאָזנים	מאָזנאַיִם
מאַחד	מעאַכעד
מאַחורי־הפּרגוד	מעאַכויריי־האַפּאַרגעד
מאַי דקאמרי רביצין	מײַ דעקאָאַמרע רעבעצן
מאַי דקאמרי רבנן	מײַ דעקאָאַמרע ראַבאָנען
מאַי טעמא	מײַ טײַמע
מאַי כּולי האַי	מײַ קולע הײַ
מאַי נפֿקא־מינה	מײַ נאַפֿקע־מינע
מאַי קאָ משמע לן	מײַ קאָ מאַשמע לאָן
מאַיים	מעײַעם
מאימת־יום־הדין	מעיימעס־יאָם־האַדין
מאיר	מייער
מאיר בעל־הנס	מייער באַל־האַנעס
מאיר בעל־נס	מייער באַל־נעס
מאכיל־טרפֿות	מײַכל־טאַרפֿעס
מאכל	מײַכל
מאכל־מלכים	מײַכל־מלאָכים
מאכלות־אַסורות	מײַכאָלעס־אַסורעס
מאכלים	מײַכאָלים
מאמין	מײַמען
מאמינים	מײַמינים
מאַמע־לשון	מאַמעלאָשן
מאמר	מײַמער
מאמר־המוסגר	מײַמער־האַמוסגער
מאמר־חז״ל	מײַמער־כאַזאַל
מאמרי־חז״ל	מײַמאָרע־כאַזאַל
מאמרים	מײַמאָרים
מאמריסטיק	מײַמעריסטיק
מאַן־דאָמר	מאַנדאָמאַר
מאַן־דהוא	מאַנדעהו
מאַנס	מעאַנעס
מאַסף	מעאַסעף
מאַסף־ממון	מעאַסעף־מאָמען
מאַרבע כּנפֿות־האָרץ	מעאַרבע קאַנפֿעס־האָאָרעץ
מאַרבע פּינות־העולם	מעאַרבע פּינעס־האָוילעם
מאריך	מײַרעך
מאריך־ימים	מײַרעך־יאָמים
מאריך־ימים־ושנים	מײַרעך־יאָמים־וועשאָנים
מאריכים	מײַריכים
מבול	מאַבל
מבולען	מאַבלען
מבטן־ולידה	מיבעטן־וועליידע
מבית־לבית	מיבאַיִס־לעבאַיִס
מבעוד־יום	מיבאָד־יאָם
מבֿאר	מעוואַער
מבֿוהל	מעוווּעל
מבֿוהלדיק	מעוווּעלדיק
מבֿוזה	מעוווּזע
מבֿוזה־ומבֿזה	מעוווּזע־אומעוואַזע
מבֿויש	מעוווּיעש
מבֿולבל	מעוווּלבל
מבֿוסם	מעוווּסעם
מבֿזה	מעוואַזע
מבֿחין	מאַפֿכן
מבֿטיח	מאַפֿטיִעך
מבֿטל	מעוואַטל
מבֿייש	מעווײַעש
מבֿין	מייוון
מבֿין־בלשון	מייוון־בעלאָשן
מבֿין־כּל־דיבור	מייוון־קאָל־דיבער
מבֿינות	מעווינעס
מבֿינטע	מייוונטע
מבֿינטעס	מייוונטעס
מבֿינים	מעווינים
מבֿלבל	מעוואַלבל
מבֿער	מעוואַער
מבֿער־חמץ	מעוואַער־כאָמעץ
מבֿקר־חולה	מעוואַקער־כוילע
מבֿשׂר	מעוואַסער
מבֿשׂר־בשׂורה	מעוואַסער־פּסורע
מגביל	מאַגביל
מגדל	מעגאַדל
מגולגל	מעגולגל
מגונה	מעגונע
מגושם	מעגושעם
מגושמדיק	מעגושעמדיק
מגזם	מעגאַזעם
מגיד	מאַגעד
מגידות	מאַגידעס
מגידים	מאַגידים
מגידקע	מאַגעדקע
מגיה	מאַגיִע
מגיים	מאַגיִיִם
מגייר	מעגײַער
מגילה	מעגילע
מגילות	מעגילעס
מגילת־איכה	מעגילעס־אייכע
מגילת־אסתּר	מעגילעס־עסטער
מגילת־רות	מעגילעס־רוס
מגלה	מעגאַלע
מגלה־טמירין	מעגאַלע־טמירן
מגמגם	מעגאַמגעם
מגן	מאָגן
מגן־דוד	מאָגן־דאָוועד
מגע־ומשׂא	מאַגעמאַסע
מגע־משׂא	מאַגעמאַסע
מגפֿה	מאַגייפֿע
מגפֿות	מאַגייפֿעס
מדאורײַתא	מידוירײַסע
מדבק	מעדאַבעק
מדבר	מידבער,מעדאַבער
מדובר	מעדובער
מדור לדור	מידאָר לעדאָר
מדחה	מאַטכע
מדי	מאָדײַ
מדי חודש בחודשו	מידיי כוידעש בעכאָטשע
מדי יום ביומו	מידיי יאָם בעיוימע
מדי שבת בשבתּו	מידיי שאַבעס בעשאַבאַטע
מדינה	מעדינע
מדינה־גייער	מעדינע־גייער
מדינה־חכם	מעדינע־כאָכעם
מדינה־חכמים	מעדינע־כאַכאָמים
מדינות	מעדינעס
מדינת־	מעדינעס
מדינת־ישׂראל	מעדינעס־ייִסראָעל
מדע	מאַדע
מדפּיס	מאַטפּעס
מדפּיסים	מאַטפּיסים
מדקדק	מעדאַקדעק
מדרבנן	מידראַבאָנען
מדרגה	מאַדרייגע
מדרגות	מאַדרייגעס
מדריך	מאַדרעך
מדריכים	מאַדריכים
מדרש	מעדרעש
מדרשים	מעדראָשים
מה	מאַ,מאָ,מע
מה אָנו ומה חיינו	מאָ אָנו אומע כאַייינע,מאָנע־מעכאַייינע
מה לי לשקר	מאַ לי לעשאַקער
מה פּשעי	מאַ פּישי
מה שמך	מאַ שמעכאָ
מה שמכם	מאַ שמייכעם
מה־בכּך	מאַבעקאַך
מה־דאָך	מאַדעך
מה־טובֿ	מאַטויוו
מה־טובֿו	מאַטויווע
מה־יוקר	מאַ־יויקער
מה־יעשׂהניק	מאַיײַסעניק
מה־יפֿית	מאַיאָפֿעס
מה־יפֿית־ייִד	מאַיאָפֿעס־ייִד
מה־יפֿית־לידל	מאַיאָפֿעס־לידל
מה־יפֿיתניק	מאַיאָפֿעסניק
מה־יקר	מאַ־יאָקער
מה־נאה	מאַ־נאָע
מה־נשתּנה	מאַ־נישטאַנע
מה־רעש	מאַראַש
מהאַי־טעמא	מעהײַ־טײַמע
מהדר	מעהאַדער
מהדרין־מן־המהדרין	מעהאַדרין־מין־האַמעהאַדרין
מהודר	מעהודער
מהודרים	מעהודאָרים
מהומה	מעהומע
מהומות	מעהומעס
מהות	מעהוס
מהחל ועד כּלה	מעהאָכייל וועאַד קאָלאָ
מהיום והלאה	מעהײַעם וואָהאָלע
מהיכא־תּיתי	מייכע־טייסע,מעכטייסע
מהיכא־תּיתידיק	מעכטייסעדיק
מהיכא־תּיתיניצע	מעכטייסעניצע
מהיכא־תּיתיניק	מעכטייסעניק
מהירות	מעהירעס
מהלך	מעהאַלעך
מהלך־רבֿ	מעהאַלעך־ראַוו
מהנה	מעהאַנע
מהפּך	מעהאַפּעך
מהר…	מאַהאַר…,מאַר…
מהרהר	מעהאַרהער,מעהאַרער
מהר״ל	מאַהאַראַל
מהר״ם	מאַהאַראַם
מהרש״אָ	מאַהאַרשאָ
מהרש״ל	מאַהאַרשאַל
מואבֿ	מויעוו
מודה	מוידע
מודה־אַני	מוידע־אַני
מודה־ומתוודה	מוידע־אומיסוואַדע
מודים	מוידים
מודיע	מוידיִע,מעדיִע
מודיעין	מאָדין,מוידיִיִן
מודעה	מוידאָע,מעדאָע
מוהל	מויעל
מוהל־מעל	מויעל־מעל
מוהלשאַפֿט	מויעלשאַפֿט
מוהר״ר	מוהאַראַר
מוותּר	מעוואַטער
מוח	מויעך
מוחות	מויכעס
מוחזק	מוכזעק
מוחל	מויכל,מויעכל,מייכל
מוחן	מויעכן
מוחרם	מוכרעם
מוטל	מוטל
מוטל־בספֿק	מוטל־בעסאָפֿעק
מוכּז	מוקאַז
מוכּ״ז	מוקאַז
מוכּת־עץ	מוקעס־עץ
מוכיח	מויכיִעך
מוכיחים	מויכיכים
מוכן	מוכן
מוכן־ומזומן	מוכן־אומזומען
מוכס	מויכעס
מוכסים	מאָכסים
מוכר	מויכער
מוכר־ספֿרים	מויכער־ספֿאָרים
מוכר־ספֿרימניק	מויכער־ספֿאָרימניק
מוכר־ספֿרימס	מויכער־ספֿאָרימס
מוכר־ספֿרימען	מויכער־ספֿאָרימען
מוכרי־ספֿרים	מאָכרע־ספֿאָרים
מוכרים	מאָכרים
מולד	מוילעד
מוליד	מוילעד
מולך	מוילעך
מולכער	מוילעכער
מום	מום
מומחה	מומכע
מומחהטע	מומכעטע
מומחהנטע	מומכענטע
מומחים	מומכים
מומים	מומים
מומר	מומער
מומר־להכעיס	מומער־לעהאַכעס
מומר־לתּאָבֿון	מומער־לעטעאָוון
מומרים	מומאָרים,מומרים
מוסיף	מויסעף
מוסכּם	מוסקעם
מוסף	מוסעף
מוספֿים	מוסאָפֿים
מוסר	מאָסער,מוסער
מוסר כּתבֿ זה	מויסער קסאַוו זע
מוסר־השׂכּל	מוסער־האַסקל
מוסר־ליטעראַטור	מוסער־ליטעראַטור
מוסר־מודעה	מויסער־מוידאָע
מוסר־נפֿש	מויסער־נעפֿעש
מוסר־ספֿר	מוסער־סייפֿער
מוסר־ספֿרים	מוסער־ספֿאָרים
מוסרט	מוסערט
מוסרן	מוסערן
מוסרניק	מוסערניק
מוסרסט	מוסערסט
מועד	מויעד
מועד־קטן	מויעד־קאָטן
מופֿלג	מופֿלעג
מופֿלג־בתּורה	מופֿלעג־באַטוירע
מופֿלג־תּורה	מופֿלעג־טוירע
מופֿלגים	מופֿלאָגים
מופֿקר	מופֿקער
מופֿקרים	מופֿקאָרים
מופֿקרת	מופֿקערעס
מופֿת	מויפֿעס
מופֿתים	מאָפֿסים
מוצא־חן	מויצע־כיין
מוצאי־	מאָצע
מוצאי־שבת	מאָצע־שאַבעס
מוציא	מויצע
מוציא־זרע־לבֿטלה	מויצע־זערע־לעוואַטאָלע
מוציא־לעז	מויצע־לאַאַז
מוציא־שם־רע	מויצע־שעמראַ
מוציא־שנתו	מויצע־שנאָסע
מוציאס	מויצעס
מוצלח	מוצלעך
מוצלחים	מוצלאָכים
מוקדם ומאוחר	מוקדעם אומעוכער
מוקיר־	מויקער
מוקירי־	מויקירע
מוקצה	מוקצע
מוקצה־מחמת־מיאוס	מוקצע־מאַכמעס־מיִעס
מוקשה	מוקשע
מורא	מוירע
מוראדיק	מוירעדיק
מוראדיקן	מוירעדיקן
מוראדיקס	מוירעדיקס
מוראדיקע	מוירעדיקע
מוראדיקער	מוירעדיקער
מורד	מוירעד
מורד־במלכות	מוירעד־בעמאַלכעס
מורדים	מאָרדים
מורדים־במלכות	מאָרדים־בעמאַלכעס
מורה־דרך	מוירע־דערעך
מורה־הוראה	מוירע־הויראָע,מוירעראָע
מורה־היתּר	מוירע־העטער
מורה־מורינו	מוירע־מויריינע
מורה־נבֿוכים	מוירע־נעוווּכים
מורנו	מויריינע,מעריינע
מורנו הרבֿ רב	מויריינע האָראַוו רעב
מורנו ורבנו הרבֿ רב	מויריינע וועראַביינע האָראַוו רעב
מורשה	מורשע
מורשים	מורשים
מושבֿ	מוישעוו
מושבֿ־זקנים	מוישעוו־סקיינים
מושבֿ־לצים	מוישעוו־לייצים
מושווה	מושווע
מושל	מוישל
מושל־בכּיפּה	מוישל־בעקיפּע
מושלים	מאָשלים
מושלים־בכּיפּה	מאָשלים־בעקיפּע
מושלם	מושלעם
מושלמים	מושלאָמים
מושלמת	מושלעמעס
מושפּע	מושפּע
מותּר	מוטער,מעוואַטער
מותר	מויסער
מותרות	מאָסרעס,מויסרעס
מזבח	מיזבייעך
מזבחות	מיזבייכעס
מזג־טובֿ	מעזעקטאָוו
מזדווג	מיזדאַוועג
מזהיר	מאַזער
מזווג	מעזאַוועג
מזוזה	מעזוזע
מזוזות	מעזוזעס
מזומן	מעזומען
מזומנים	מעזומאָנים
מזונות	מעזוינעס
מזיוו־השכינה	מעזיוו־האַשכינע
מזיק	מאַזעק
מזיקים	מאַזיקים
מזיקן	מאַזיקן
מזכּה	מעזאַקע
מזכּיר	מאַסקער
מזכּיר־נשמות	מאַסקער־נעשאָמעס
מזל	מאַזל
מזל אַריה	מאַזל אַריע
מזל בתולה	מאַזל פּסולע
מזל גדי	מאַזל געדי
מזל דגים	מאַזל דאָגים
מזל דלי	מאַזל דעלי
מזל טלה	מאַזל טאָלע
מזל מאָזנים	מאַזל מאָזנאַיִם,מאָזנאַיִם
מזל סרטן	מאַזל סאַרטן
מזל עקרבֿ	מאַזל אַקרעוו
מזל קשת	מאַזל קאַשעס
מזל שור	מאַזל שאָר
מזל תּאומים	מאַזל טוימים
מזל־ברכה	מאַזל־בראָכע
מזל־טובֿ	מאַזלטאָוו
מזלות	מאַזאָלעס
מזלזל	מעזאַלזל
מזנה	מעזאַנע
מזרז	מעזאַרעז
מזרחי	מיזראָכי
מחבבֿ	מעכאַבעוו
מחבל	מעכאַבל
מחבלים	מעכאַבאָלים,מעכאַבלים
מחבק־ומנשק	מעכאַבעק־אומענאַשעק
מחבר	מעכאַבער
מחברים	מעכאַברים
מחברס	מעכאַבערס
מחדש	מעכאַדעש
מחדשים	מעכאַדשים,מעכאַטשים
מחה	מאָכע
מחויבֿ	מעכוּיעוו
מחויבֿ־גלות	מעכוּיעוו־גאָלעס
מחולק	מעכולעק
מחוסר־	מעכוסער
מחוסר־לחם	מעכוסער־לעכעם
מחוסרי־	מעכוסרע
מחוסרי־לחם	מעכוסרע־לעכעם
מחוץ	מיכוץ,מעכוץ
מחוץ־לאָרץ	מיכוץ־לאָאָרעץ,מעכוץ־לאָאָרעץ
מחוץ־לדרך־הטבֿע	מיכוץ־לעדערעך־האַטעווע,מעכוץ־לעדערעך־האַטעווע
מחוץ־למחנה	מיכוץ־לאַמאַכנע,מעכוץ־לאַמאַכנע
מחוץ־לעיר	מיכוץ־לאָיִר,מעכוץ־לאָיִר
מחוצנער	מעכוצענער
מחוצף	מעכוצעף
מחוצף־פּנים	מעכוצעף־פּאָנעם
מחוצפֿטע	מעכוצעפֿטע
מחוצפֿים	מעכוצאָפֿים
מחותּן	מעכוטן
מחותּנותשאַפֿט	מאַכעטאָנעשאַפֿט,מעכוטאָנעסשאַפֿט
מחותּנים	מאַכעטאָנים,מעכוטאָנים
מחותּנימשאַפֿט	מעכוטאָנעמשאַפֿט
מחותּנישאַפֿט	מעכוטאָנעשאַפֿט
מחותּנס	מעכוטנס
מחותּנתטע	מאַכעטענעסטע,מעכוטענעסטע
מחותּנתטעס	מאַכעטענעסטעס,מעכוטענעסטעס
מחזור	מאַכזער
מחזורים	מאַכזוירים
מחזיק	מאַכזעק
מחזיק־טובֿה	מאַכזעק־טויווע
מחזיר־למוטבֿ	מאַכזיר־לעמוטעוו
מחזקות	מאַכזאָקעס
מחיה	מיכיע,מעכײַע
מחיה־מתים	מעכײַע־מייסים
מחיה־נפֿשות	מעכײַע־נעפֿאָשעס
מחיות	מעכײַעס
מחייבֿ	מעכײַעוו
מחילה	מעכילע
מחילה־גמורה	מעכילע־גמורע
מחיצה	מעכיצע
מחיצות	מעכיצעס
מחלה	מאַכלע
מחלוקה	מאַכלויקע
מחלוקות	מאַכלויקעס
מחלוקת	מאַכלויקעס
מחלוקתן	מאַכלויקעסן
מחלות	מאַכלעס
מחלל	מעכאַלעל
מחלל־השם	מעכאַלעל־האַשעם
מחלל־קודש	מעכאַלעל־קוידעש
מחלל־שבת	מעכאַלעל־שאַבעס
מחלל־שם	מעכאַלעל־שעם
מחלל־שם־שמים	מעכאַלעל־שעם־שאָמאַיִם
מחלל־שם־שמים בפֿרהסיא	מעכאַלעל־שעם־שאָמאַיִם בעפֿערעסיע
מחלת בת־נעמה	מאַכלעס באַס־נײַמע
מחמדאַניש	מאַכמעדאַניש
מחמדאַנער	מאַכמעדאַנער
מחמיץ	מאַכמעץ
מחמיר	מאַכמער
מחמירים	מאַכמירים
מחמת	מאַכמעס
מחנה	מאַכנע
מחנות	מאַכנעס
מחנותווײַז	מאַכנעסווײַז
מחנך	מעכאַנעך
מחסר	מעכאַסער
מחק	מכאַק,מעכאַק
מחריבֿ	מאַכרעוו
מחרים	מאַכרעם
מחרים־עולם	מאַכרעם־אוילעם
מחרף־ומגדף	מעכאַרעף־אומעגאַדעף
מחשבֿה	מאַכשאָווע
מחשבֿה־זרה	מאַכשאָווע־זאָרע
מחשבֿה־טובֿה	מאַכשאָווע־טויווע
מחשבֿה־רעה	מאַכשאָווע־ראָע
מחשבֿות	מאַכשאָוועס
מחשבֿותן	מאַכשאָוועסן
מ״ט שערי־טומאה	מעם־טעס שאַאַרע־טומע
מטבע	מאַטבייע
מטבעות	מאַטבייעס
מטה	מאַטע,מיטע
מטה־מטה	מאַטע־מאַטע,מאַטע־־מאָטע
מטהר	מעטאַער
מטופּל	מעטופּל
מטופּלים	מעטופּאָלים
מטורף	מעטורעף
מטורפֿים	מעטוראָפֿים
מטורפֿת	מעטורעפֿעס
מטושטש	מעטושטעש
מטות	מאַטעס
מטות־ומסעי	מאַטעס־אומאַסע
מטות־מסעי	מאַטעס־מאַסע
מטטרון	מעטאַטרען
מטיבֿ	מייטעוו
מטיבֿ־חלום	מייטעוו־כאָלעם
מטיף	מאַטעף
מטיפֿים	מאַטיפֿים
מטלטלים	מעטאַלטעלים
מטלטלין	מעטאַלטעלן
מטמא	מעטאַמע
מטמון	מאַטמען
מטמונים	מאַטמוינים
מטעים	מאַטעם
מטעמים	מאַטאַמים
מטפּל	מעטאַפּל
מטרוניתא	מאַטרעניסע
מטריח	מאַטריִעך
מי ומי	מי וואָמי
מי ומי ההולכים	מי וואָמי האָהוילכים
מי יחיה	מי ייִכיע
מי ימות	מי יאָמעס
מי לנו גדול מ…	מי לאָנו גאָדל מי…
מי שנכנס אָדר	מישעניכנעס אָדער
מי שׂמך	מי סאָמכאָ
מי־בֿאש ומי־בֿמים	מי־וואָייש אומי־וואַמאַיִם
מי־יודע	מידייע,מי־יעדייע
מי־שברך	מישעביירעך
מיאוס	מיִעס
מיאוס־ומאָוס	מיִעס־אומאָעס
מיאוסן	מיִעסן
מיאוסע	מיִעסע
מיאוסער	מיִעסער
מיאוסקייט	מיִעסקייט
מיאוסקייטן	מיִעסקייטן
מיאש	מעיאַעש
מיבם	מעיאַבעם
מיגו	מיגע
מיגיע־כּפּו	מיגיִע־קאַפּע
מיגיע־כּפּיה	מיגיִע־קאַפּעאָ
מיגיע־כּפּיו	מיגיִע־קאַפּעוו
מיד	מיִיאַד
מיד־ליד	מיִיאַד־לעיאַד
מידבר	מידבער
מידבריות	מידבאָריעס
מידה	מידע
מידה כּנגד מידה	מידע קענעגעד מידע
מידה־בזויה	מידע־בזוּיע
מידה־טובֿה	מידע־טויווע
מידה־מגונה	מידע־מעגונע
מידות	מידעס
מידין	מידיען
מידת־הדין	מידעס־האַדין
מידת־הרחמים	מידעס־האָראַכמים
מידת־סדום	מידעס־זדאָם
מיוחס	מעיוכעס
מיוחסטע	מעיוכעסטע
מיוחסים	מעיוכאָסים
מיוחסת	מעיוכעסעס
מיושבֿ	מעיושעוו
מיושבֿדיק	מעיושעוודיק
מיזמור	מיזמער
מיזמורים	מיזמוירים
מיזרח	מיזרעך
מיזרחים	מיזראָכים
מיחד	מעיאַכעד
מיחוש	מייכעש
מיחושים	מייכושים
מיחס	מעיאַכעס
מיטה	מיטע
מיישבֿ	מעיאַשעוו
מיכאל	מיכאָעל
מיכה	מיכע
מיכשול	מיכשל
מיכשולים	מיכשוילים
מיכתּבֿ	מיכטעוו
מיכתּבֿים	מיכטאָווים
מילא	מיילע
מילה	מילע
מילי־דעלמא	מילע־דעאַלמע
מילתא־דבדיחותא	מילסע־דיבדיכעסע,מילע־דיבדיכעסע
מים	מאַיִם
מים־אַחרונים	מאַיִם־אַכרוינים
מים־חיים	מאַיִם־כאַיִם
מים־שאין־להם־סוף	מאַיִם־שעיין־לאָהעם־סאָף
מים־שלנו	מאַיִם־שעלאָנו
מימרא	מעמרע
מין	מין
מין־זכר	מין־זאָכער
מין־נקבֿה	מין־נעקייווע
מין־סתּם	מין־סטאַם
מינהג	מינעג
מינהג־המדינה	מינעג־האַמעדינע
מינהג־העולם	מינעג־האָוילעם
מינהג־ישן	מינעג־יאָשן
מינהג־שטות	מינעג־שטוס
מינהגים	מינהאָגים
מינות	מינעס
מינחה	מינכע
מינחה־גדולה	מינכע־גדוילע
מינחה־קטנה	מינכע־קטאַנע
מיני־קיטניות	מינע־קיטניעס
מינים	מינים
מיסד	מעיאַסעד
מיסדים	מעיאַזדים
מיסחר	מיסכער
מיסחרים	מיסכאָרים
מיספּר	מיספּער
מיספּר־גדול	מיספּער־גאָדל
מיספּר־קטן	מיספּער־קאָטן
מיספּרים	מיספּאָרים
מיעוט	מיִעט
מיעוטים	מיִוטים
מיצווה	מיצווע
מיצווה־טאַנץ	מיצווע־טאַנץ
מיצוות	מיצוועס
מיצוות־לא־תעשׂה	מיצוועס־לויסײַסע,מיצוועס־לויסעסע
מיצוות־עשׂה	מיצוועס־אײַסע,מיצוועס־עסע
מיצרי	מיצרי
מיצריות	מיצריִעס
מיצריש	מיצריש
מיצרית	מיצריס
מיקדש	מיגדעש
מיקוואָות	מיקוואָעס
מיקווה	מיקווע
מיקוות	מיקוואָעס
מיקלט	מיקלעט
מיקלטים	מיקלאָטים
מיקרה	מיקרע
מיקרים	מיקרים
מישבֿ	מעיאַשעוו
מישכּבֿ־בהמה	מישקעוו־בעהיימע
מישכּבֿ־זכור	מישקעוו־זאָכער
מישכּבֿ־זכר	מישקעוו־זאָכער
מישכּן	מישקן
מישמר	מישמער
מישמרים	מישמאָרים
מישנה	מישנע
מישנה־למלך	מישנע־לאַמיילעך
מישנה־תּורה	מישנע־טוירע
מישפּט	מישפּעט
מישפּטים	מישפּאָטים
מישפּטן	מישפּעטן
מישקל	מישקל
מישקלים	מישקאָלים
מיתּר	מעיאַטער
מיתה	מיסע
מיתה־בנשיקה	מיסע־בינשיקע
מיתה־משונה	מיסע־מעשונע
מכּבי	מאַקאַבי
מכּבייער	מאַקאַבייער
מכּה	מאַקע
מכּה אַשר לא כּתובֿה בתּורה	מאַקע אַשער לוי קסוּווע באַטוירע
מכּה שלא כּתובֿה בתּורה	מאַקע שעלוי קסוּווע באַטוירע
מכּוח	מיקויעך
מכּוח אל הפּועל	מיקויעך על האַפּויעל
מכּוחן	מיקויעכן
מכּות	מאַקעס
מכּות־אַכזריות	מאַקעס־אַכזאָריעס
מכּות־רצח	מאַקעס־רעצעך
מכּחיש	מאַקכעש
מכּיר־טובֿה	מאַקער־טויווע
מכּל־המינים	מיקאָל־האַמינים
מכּל־המינים־שהוא	מיקאָל־האַמינים־שעהו
מכּל־טובֿ	מיקאָל־טוּוו
מכּל־מאמינים־שהוא	מיקאָל־מײַמינים־שעהו
מכּל־שכּן	מיקאָלשקן
מכּלומרשט	מיקלוימערשט
מכּמה	מיקאַמע
מכּמה טעמים	מיקאַמע טײַמים
מכּמה שנים	מיקאַמע שאָנים
מכּמה־וכּמה טעמים	מיקאַמע־וועקאַמע טײַמים
מכּמה־וכּמה שנים	מיקאַמע־וועקאַמע שאָנים
מכּת־בכורות	מאַקעס־פּכוירעס
מכּת־מדינה	מאַקעס־מעדינע
מכבד	מעכאַבעד
מכביד	מאַכבעד
מכובד	מעכובעד
מכובדים	מעכובאָדים
מכוון	מעכאַוון
מכולה	מעכולע
מכוערת	מעכוערעס,מעכוראַס
מכין	מייכן
מכירה	מעכירע
מכירת־חמץ	מעכירעס־כאָמעץ
מכירת־יוסף	מעכירעס־יויסעף
מכניס־אורח	מאַכנעס־אוירעך
מכניס־אורחטע	מאַכנעס־אוירעכטע
מכניסי־אורחים	מאַכניסע־אָרכים
מכנסים	מיכנעסאַיִם
מכס	מעכעס
מכפּר	מעכאַפּער
מכפּר־פּנים	מעכאַפּער־פּאָנעם
מכריז	מאַכרעז
מכריז־ומודיע	מאַכרעז־אומוידיִע
מכריע	מאַכריִע
מכשיל	מאַכשל
מכשיר	מאַכשער
מכשירים	מאַכשירים
מכשירין	מאַכשירין
מכשף	מעכאַשעף
מכשפֿה	מאַכשייפֿע
מכשפֿהטע	מאַכשייפֿטע
מכשפֿהטעס	מאַכשייפֿטעס
מכשפֿהס	מאַכשייפֿעס
מכשפֿות	מאַכשייפֿעס
מכשפֿטע	מאַכשייפֿטע,מעכאַשעפֿטע
מכשפֿטעס	מאַכשייפֿטעס
מכשפֿים	מעכאַשפֿים
מל	מאַל
מלא	מאָלע
מלא־	מאָלע
מלא־גדולה	מאָלע־געדולע
מלא־גזלן	מאָלע־גאַזלען
מלא־המן	מאָלע־האָמען
מלא־וגדוש	מאָלע־וועגאָדעש
מלא־חמה	מאָלע־כיימע
מלא־חן	מאָלע־כיין
מלא־טעם	מאָלע־טאַם
מלא־כּעס	מאָלע־קאַאַס
מלא־קומתו	מלוי־קוימאָסע
מלא־רחמים	מאָלע־ראַכמים
מלא־רציחה	מאָלע־רעציכע
מלא־שׂימחה	מאָלע־סימכע
מלאך	מאַלעך
מלאך־דומה	מאַלעך־דוימע
מלאך־הגואל	מאַלעך־האַגויעל
מלאך־הדומה	מאַלעך־האַדוימע
מלאך־המוות	מאַלכאַמאָוועס,מאַלעכאַמאָוועס
מלאך־המושיע	מאַלעך־האַמוישיִע
מלאך־השלום	מאַלעך־האַשאָלעם
מלאך־חבלה	מאַלעך־כאַבאָלע
מלאך־עליון	מאַלעך־עליען
מלאָכה	מעלאָכע
מלאָכה־בזויה	מעלאָכע־בזוּיע
מלאָכהן	מעלאָכען
מלאָכהנען	מעלאָכענען
מלאָכות	מעלאָכעס
מלאָכי	מאַלאָכי
מלאַכי־השלום	מאַלאַכע־האַשאָלעם
מלאַכי־השרת	מאַלאַכיי־האַשאָרעס
מלאַכי־חבלה	מאַלאַכע־כאַבאָלע
מלאַכי־עליון	מאַלאַכע־עליען
מלאכים	מאַלאָכים
מלאכימלעך	מאַלאָכימלעך
מלאכימס	מאַלאָכימס
מלאכס	מאַלעכס
מלבוש	מאַלבעש
מלבושים	מאַלבושים
מלבושימלעך	מאַלבושימלעך
מלבושל	מאַלבעשל
מלביש	מאַלבעש
מלביש־ומנעיל	מאַלבעש־אומאַניל
מלביש־ערומים	מאַלבעש־אַרומים
מלווה	מאַלווע,מעלאַווע
מלווה־בריבית	מאַלווע־בעריביס
מלווה־מלכּה	מעלאַווע־מאַלקע
מלווים	מאַלווים,מעלאַווים
מלווים־בריבית	מאַלווים־בעריביס
מלוכה	מעלוכע
מלוכות	מעלוכעס
מלומד	מעלומעד
מלומדות	מעלומדעס
מלומדים	מעלומאָדים
מלומדת	מעלומעדעס
מלופּן	מעלופּן
מלחמה	מילכאָמע
מלחמות	מילכאָמעס
מלחמת־גוג־ומגוג	מילכעמעס־גאָג־אומאָגעג
מליץ	מיילעץ
מליץ־יושר	מיילעץ־יוישער
מליץ־יושרטע	מיילעץ־יוישערטע
מליצה	מעליצע
מליצות	מעליצעס
מליצי־יושר	מעליצע־יוישער
מליצים	מעליצים
מלכּא־קדישא	מאַלקע־קעדישע
מלכּה	מאַלקע
מלכּה־שבֿאָ	מאַלקע־שוואָ
מלכּהלע	מאַלקעלע
מלכּהלען	מאַלקעלען
מלכּהלעס	מאַלקעלעס
מלכּהן	מאַלקען
מלכּהס	מאַלקעס
מלכּות	מאַלקעס
מלכּיאל	מאַלקיִעל
מלך	מיילעך
מלך־אבֿיון	מיילעך־עוויען
מלך־בכּיפּה	מיילעך־בעקיפּע
מלך־חסד	מיילעך־כעסעד
מלך־מלכי־המלכים	מיילעך־מאַלכע־האַמלאָכים
מלכות	מאַלכעס
מלכות־הרשע	מאַלכעס־האָרעשע
מלכות־הרשעה	מאַלכעס־האָרעשאָע
מלכות־יהודה	מאַלכעס־יעהודע
מלכות־ישׂראל	מאַלכעס־ייִסראָעל
מלכות־שמים	מאַלכעס־שאָמאַיִם
מלכותדיק	מאַלכעסדיק
מלכים	מלאָכים
מלמד	מעלאַמעד
מלמד־זכות	מעלאַמעד־סכוס
מלמדות	מעלאַמדעס
מלמדים	מעלאַמדים
מלמדקע	מעלאַמעטקע
מלן	מאַלן
מלע	מאַלע
מלעיל	מילעל
מלען	מאַלען
מלקות	מאַלקעס
מלרע	מילראַ
מלשין	מאַלשן
מלשינות	מאַלשינעס
מם	מעם
ממה־נפֿשך	מאָנעפֿשעך,מאָנעשעך
ממוכן	מעמוכן
ממון	מאָמען
ממון־קורח	מאָמען־קוירעך
ממונה	מעמונע
ממונים	מעמונים
ממזר	מאַמזער
ממזר־בן־הנידה	מאַמזער־בען־האַנידע
ממזרטע	מאַמזערטע
ממזרטעס	מאַמזערטעס
ממזרים	מאַמזיירים
ממזריש	מאַמזעריש
ממזרישן	מאַמזערישן
ממזרישע	מאַמזערישע
ממזרישער	מאַמזערישער
ממזרס	מאַמזערס
ממזרת	מאַמזיירעס
ממילא	מימיילע
ממיתן	מיימעסן
ממלא	מעמאַלע
ממלא־מקום	מעמאַלע־מאָקעם
ממלא־מקומו	מעמאַלע־מעקוימע
ממליץ	מאַמלעץ
ממעמקים	מימאַאַמאַקים
ממציא	מאַמצע
ממש	מאַמעש
ממשות	מאַמאָשעס
ממשיך	מאַמשעך
ממשלה	מעמשאָלע
ממתּקים	מאַמטאַקים
מן	מאַן,מין
מן הכּוח אל הפּועל	מין האַקויעך על האַפּויעל
מן־הדין	מינאַדין
מן־המובֿחר	מין־האַמופֿכער
מן־הסתּם	מינאַסטאַם
מן־הצד	מינאַצאַד
מן־השמים	מין־אַשאָמאַיִם,מין־האַשאָמאַיִם
מן־השׂפֿה־ולחוץ	מין־האַסאָפֿע־וועלאַכוץ
מן־התּורה	מין־האַטוירע
מנגן	מענאַגן
מנדבֿ	מענאַדעוו
מנדבֿים	מענאַדווים
מנדר	מענאַדער
מנה־יפֿה	מאָנע־יאָפֿע
מנהיג	מאַנעג
מנהיג־הדור	מאַנעג־האַדאָר
מנהיגי־הדור	מאַנהיגע־האַדאָר
מנהיגים	מאַנהיגים
מנהל	מענאַהעל
מנהלים	מענאַלים
מנוּוול	מענוּוול
מנוּוולטע	מענוּוולטע
מנוּוולטעס	מענוּוולטעס
מנוּוולים	מענוּוואָלים
מנוּוולת	מענוּוועלעס
מנוחה	מענוכע
מנוקד	מענוקעד
מנורה	מענוירע
מנורות	מענוירעס
מנורת־המאור	מענוירעס־האַמאָער
מנחות	מנאָכעס
מנחם	מענאַכעם
מנחם־אָבֿ	מענאַכעמאָוו
מנחם־אָבֿל	מענאַכעם־אָוול
מנחמס	מענאַכעמס
מנחמען	מענאַכעמען
מניה־וביה	מעניי־אוּוויי,מענייביי
מנין	מיניען
מנינים	מיניאָנים
מניעה	מעניִע
מניעות	מעניִעס
מנכּה	מענאַקע
מנער ועד זקן	מינאַאַר וועאַד זאָקן
מנצח	מענאַצייעך
מנקר	מענאַקער
מנקרים	מענאַקרים
מנשה	מענאַשע
מנשהכע	מענאַשעכע
מנשהכען	מענאַשעכען
מנשהכעס	מענאַשעכעס
מנשהן	מענאַשען
מנשהס	מענאַשעס
מס	מאַס
מסבבֿ	מעסאַבעוו
מסבבֿ־כּל־הסיבות	מעסאַבעוו־קאָל־האַסיבעס
מסביר	מאַסבער
מסדר	מעסאַדער
מסדר־קידושין	מעסאַדער־קדושן,מעסאַדער־קידושן
מסוגל	מעסוגל
מסוכּן	מעסוקן
מסופּק	מעסופּעק
מסור	מאָסער
מסורה	מעסוירע
מסורים	מאָסרים
מסיבה	מעסיבע
מסיבות	מעסיבעס
מסיג־גבֿול	מאַסעג־גוווּל
מסיח־לפֿי־תּומו	מייסיִעך־לעפֿי־טומע
מסיים	מעסײַעם
מסיכתּא	מעסיכטע
מסיכתּות	מעסיכטעס
מסים	מיסים
מסיני	מיסינײַ
מסירה	מעסירע
מסירהלע	מעסירעלע
מסירות	מעסירעס
מסירת־הנפֿש	מעסירעס־האַנעפֿעש
מסירת־מודעה	מעסירעס־מעדאָע
מסירת־נפֿש	מעסירעס־נעפֿעש
מסית־ומדיח	מייסיס־אומעדיִעך
מסכּים	מאַסקעם
מסכתּא	מעסעכטע
מסכתּות	מעסעכטעס
מסכת	מאַסעכעס
מסלסל־בשׂערו	מעסאַלסל־בעסיירע
מסלק	מעסאַלעק
מסעות בנימין השלישי	מאַסאָעס בעניאָמען האַשלישי
מסעי	מאַסע
מספּיד	מאַספּעד
מספּידים	מאַספּידים
מסקנא	מאַסקאָנע
מסקנות	מאַסקאָנעס
מסר	מאַסער
מסרט	מאַסערט
מסריח	מאַסריִעך
מסרן	מאַסערן
מסרנדיק	מאַסערנדיק
מסרס	מעסאַרעס
מסרסט	מאַסערסט
מסתּגף	מיסטאַגעף
מסתּם	מיסטאַם
מסתּמא	מיסטאַמע,מיסטאָמע
מסתּפּק־במועט	מיסטאַפּעק־בעמועט
מסתּפּקים־במועט	מיסטאַפּקים־בעמועט
מעבֿדות לחירות	מעאַוודעס לעכיירעס
מעבֿיר	מײַווער
מעבֿיר־נחלה	מײַווער־נאַכלע
מעבֿיר־סדרה	מײַווער־סעדרע
מעבֿר־יבוק	מײַווער־יאַבעק
מעבֿר־לים	מעייווער־לעיאַם
מעגן	מעאַגן
מעדני־מלך	מײַדאַנע־מיילעך
מעדני־מלכים	מײַדאַנע־מלאָכים
מעדנים	מײַדאַנים
מעוברת	מעובערעס
מעוז־צור	מאָויז־צור
מעור אחד	מעויר עכאָד
מעורבֿ־עם־הבריות	מעורעוו־אים־האַבריִעס
מעורר	מעוירער
מעות	מאָעס
מעות־חיטים	מאָעס־כיטים
מעות־חיטין	מאָעס־כיטן
מעיד	מעיִד
מעיז	מעיִז
מעיז־פּנים	מעיִז־פּאָנעם
מעיין	מעײַען
מעילה	מעיִלע
מעכּבֿ	מעאַקעוו
מעכּבֿ־הקריאה	מעאַקעוו־האַקריִע
מעכּל	מעאַקל
מעלה	מײַלע
מעלה־גירה	מײַלע־גיירע
מעלה־גירהן	מאַלגיירען,מאַלעגיירען
מעלות	מײַלעס
מעלים	מײַלעם
מעלין בקודש	מײַלן באַקוידעש
מעלתו	מײַלאָסע
מעמד	מײַמעד
מעמדות	מײַמאָדעס
מעמיק	מײַמעק
מעמקים	מאַאַמאַקים
מענה	מײַנע
מענה־לשון	מײַנע־לאָשן
מענות	מײַנעס
מעניני־דיומא	מעיִניאָנע־דעיוימע
מעניש	מײַנעש
מעפּילים	מאַאַפּילים
מעקרן	מײַקערן
מערבֿ	מײַרעוו
מערה	מאַאַרע,מיירע,מײַרע
מעריבֿ	מײַרעוו
מערכה	מאַראָכע
מערכות	מאַראָכעס
מערער	מעאַרער
מערת־המכפּלה	מעאָרעס־האַמאַכפּיילע
מערת־פּריצים	מעאָרעס־פּריצים
מעשיר	מײַשער
מעשׂה	מײַסע
מעשׂה־אונן	מײַסע־אוינען
מעשׂה־ביכל	מײַסע־ביכל
מעשׂה־בראשית	מײַסע־בריישעס
מעשׂה־בתּוך־מעשׂה	מײַסע־בעטאָך־מײַסע
מעשׂה־מרכּבֿה	מײַסע־מערקאָווע
מעשׂה־נורא	מײַסע־נוירע
מעשׂה־ניפֿלא	מײַסע־ניפֿלע
מעשׂה־נסים	מײַסע־ניסים
מעשׂה־סדום	מײַסע־סדאָם
מעשׂה־רע	מײַסע־ראַ
מעשׂה־שהיה	מײַסע־שעהויע
מעשׂה־שׂטן	מײַסע־סאָטן
מעשׂה־תּעתּועים	מײַסע־טאַטויִם
מעשׂי־ידי	מײַסע־יאָדײַ
מעשׂי־ידיו	מײַסע־יאָדאָוו
מעשׂיות	מײַסעס
מעשׂים	מײַסים
מעשׂים־אשר־לא־יעשׂו	מײַסים־אַשער־לוי־יעאָסו
מעשׂים־בכל־יום	מײַסים־בעכאָל־יאָם
מעשׂים־טובֿים	מײַסים־טויווים
מעשׂים־רעים	מײַסים־ראָיִם
מעשׂים־תּעתּועים	מײַסים־טאַטויִם
מעשׂר	מײַסער
מעשׂר־שני	מײַסער־שייני
מעשׂרות	מײַסרעס
מעתּיק	מײַטעק
מעתּיקים	מאַטיקים
מעת־לעת	מעסלעס
מפּולת	מאַפּוילעס
מפּיו־הקדוש	מיפּיוו־האַקאָדעש
מפּיל	מאַפּל
מפּיל־קינד	מאַפּלקינד
מפּיל־קינדער	מאַפּלקינדער
מפּילעך	מאַפּעלעך
מפּלה	מאַפּאָלע
מפּלות	מאַפּאָלעס
מפּלען	מאַפּלען
מפּני־דרכּי־שלום	מיפּניי־דאַרקע־שאָלעם
מפּתח־ביתו	מיפּעסעך־בייסע
מפֿולפּל	מעפֿולפּל
מפֿוניצע	מעפֿוניצע
מפֿוניצעס	מעפֿוניצעס
מפֿונק	מעפֿונעק
מפֿונקים	מעפֿונאָקים
מפֿורסם	מעפֿאָרסעם,מעפֿורסעם
מפֿורסמים	מעפֿורסאָמים
מפֿטיר	מאַפֿטער
מפֿייס	מעפֿײַעס
מפֿיצי־השׂכּלה	מעפֿיצע־האַסקאָלע
מפֿיצי־שׂפֿת־עבֿר	מעפֿיצע־ספֿאַס־אייווער
מפֿליא־לעשׂות	מאַפֿלע־לײַסעס
מפֿליג	מאַפֿלעג
מפֿלפּל	מעפֿאַלפּל
מפֿסיק	מאַפֿסעק
מפֿסיק־משנתו	מאַפֿסעק־מישנאָסע
מפֿצה	מעפֿאַצע
מפֿציר	מאַפֿצער
מפֿקיר	מאַפֿקער
מפֿרנס	מעפֿאַרנעס
מפֿרסם	מעפֿאַרסעם
מפֿרש	מעפֿאַרעש
מפֿרשים	מעפֿאָרשים
מפֿתּה	מעפֿאַטע
מצבֿ	מאַצעוו
מצבֿה	מאַצייווע
מצבֿות	מאַצייוועס
מצד	מיצאַד
מצדיק	מאַצדעק
מצדיק־הדין	מאַצדעק־האַדין
מצה	מאַצע
מצה־וואַסער	מאַצע־וואַסער
מצה־שמורה	מאַצע־שמורע
מצודת־דוד	מעצודעס־דאָוויד
מצודת־ציון	מעצודעס־ציִען
מצורע	מעצוירע
מצורעים	מעצויראָיִם
מצורעת	מעצויראַאַס
מצות	מאַצעס
מצטרף	מיצטאַרעף
מציאה	מעציִע
מציאות	מעציִעס
מציל	מאַצל
מציצה	מעציצע
מצליח	מאַצליִעך
מצמצם	מעצאַמצעם
מצנפֿת	מיצנעפֿעס
מצער	מעצאַער
מצרים	מיצראַיִם
מצרף	מעצאַרעף
מקבל	מעקאַבל
מקבל־באַהבֿה	מעקאַבל־בעאַאַווע,מעקאַבל־בעאַהאַווע
מקבל־נחת	מעקאַבל־נאַכעס
מקבל־פּנים	מעקאַבל־פּאָנעם
מקבל־קנין	מעקאַבל־קיניען
מקבל־שבת	מעקאַבל־שאַבעס
מקבל־תּענוג	מעקאַבל־טײַנעג
מקבר	מעקאַבער
מקדים	מאַקדעם
מקדיש	מאַקדעש
מקדמונים	מיקאַדמוינים
מקדמת־דנאָ	מיקאַדמעס־דענאָ
מקדש	מיקדעש,מעקאַדעש
מקדש־השם	מעקאַדעש־האַשעם
מקהילה־קדושה	מיקעהילע־קדוישע
מקובל	מעקובל
מקובלים	מעקובאָלים
מקוים	מעקוּיעם
מקום	מאָקעם
מקום־גדול	מאָקעם־גאָדל
מקום־לפּורעניות	מאָקעם־לעפּוראָניעס
מקום־מיקלט	מאָקעם־מיקלעט
מקום־מנוחה	מאָקעם־מענוכע
מקום־קדוש	מאָקעם־קאָדעש
מקומות	מעקוימעס
מקונן	מעקוינען
מקוננים	מעקאָנענים
מקור	מאָקער
מקורבֿ	מעקורעוו
מקורבֿים	מעקוראָווים
מקורות	מעקוירעס
מקורים	מעקוירים
מקח	מעקעך
מקח־וממכּר	מעקעך־אומעמקער
מקח־טעות	מעקעך־טאָעס
מקחים	מעקאָכים
מקטן־ועד־גדול	מיקאָטן־ועאַד־גאָדל
מקטרג	מעקאַטרעג
מקטרגים	מעקאַטרייגים
מקיאן	מייקען
מקיאנען	מייקענען
מקיים	מעקײַעם
מקיים־פּסק	מעקײַעם־פּסאַק
מקיל	מייקל
מקילים	מעקילים
מקמץ	מעקאַמעץ
מקנא	מעקאַנע
מקפּח	מעקאַפּייעך
מקפּיד	מאַקפּעד
מקפּידים	מאַקפּידים
מקף	מאַקעף
מקץ	מיקעץ
מקצר	מעקאַצער
מקצר־ימים	מעקאַצער־יאָמים
מקצר־ימים־ושנים	מעקאַצער־יאָמים־וועשאָנים
מקצרים	מעקאַצרים
מקצת־מן־המקצת	מיקצעס־מין־האַמיקצעס
מק״ק	מיקאַק
מקראָות־גדולות	מיקראָעס־גדוילעס
מקרבֿ	מעקאַרעוו
מקריבֿ	מאַקרעוו
מקשה	מאַקשע
מקשה־לילד	מאַקשע־ליילעד,מעקאַשע־ליילעד
מקשן	מאַקשן
מקשנים	מאַקשאָנים
מר־בר־רב־אַשי	מאַרבערעבאַשע
מר־ברב־אַשי	מאַרבערעבאַשע
מר־ממוות	מאַר־מימאָוועס
מר־נפֿש	מאַרנעפֿעש,מאָרע־נעפֿעש
מרא־דאַתרא	מאָרע־דאַסרע,מאָרע־דעאַסרע
מראה	מאַרע
מראה־כּהן	מאַרע־קויען
מראה־מקום	מאַרע־מאָקעם
מראה־מקומות	מאַרע־מעקוימעס
מראית־עין	מאַריס־אַיִן
מרבין בשׂימחה	מאַרבן בעסימכע
מרביץ־תּורה	מאַרבעץ־טוירע
מרגיל	מאַרגל
מרגיש	מאַרגעש
מרגל	מעראַגל
מרגניתא־טבֿא	מאַרגניסע־טאַווע
מרדכי	מאָרטכע
מרדכי הצדיק	מאָרטכע האַצאַדיק
מרדכין	מאָרטכען
מרדכיס	מאָרטכעס
מרה־שחורה	מאָרעשכוירע
מרובה	מערובע
מרובע	מערובע
מרובעים	מערובאָיִם
מרוויח	מאַרוויִעך
מרוויחער	מאַרוויכער,מאַרעוויכער
מרוח־אָשך	מערויעך־אָשעך,מרויעך־אָשעך
מרוצה	מערוצע
מרוצה־לבריות	מערוצע־לאַבריִעס
מרור	מאָרער
מרחיבֿ	מאַרכעוו
מרחיק	מאַרכעק
מרחם	מעראַכעם
מרחץ	מערכעץ
מרחק	מעראַכעק,מערכעק
מרחקים	מערכאַקים
מרחשוון	מאַרכעזשוון
מרידה	מערידע
מרידות	מערידעס
מריה־דאַבֿרהם	מאָרע־דאַווראָהאָם
מריה־דעלמא־כּולה	מאָרע־דעאַלמע־קולע
מרים	מאַריעם,מיריעם
מרים הנבֿיאה	מיריעם האַנעוויִע
מרים הנבֿיאהס	מיריעם האַנעוויִעס
מרימס	מאַריעמס,מיריעמס
מרימען	מאַריעמען,מיריעמען
מרכּבֿה	מערקאָווע
מרכא־טיפּחא	מערכע־טיפּכע
מרמז	מעראַמעז
מרנן ורבנן ורבותי	מאָראָנאָן וועראַבאָנאָן וועראַבויסײַ
מרעיש	מאַרעש
מרעיש־עולם	מאַרעש־אוילעם
מרשעת	מאַרשאַס,מירשאַס
מרשעתן	מאַרשאַסן,מירשאַסן
מרת	מאָרעס
משאל־עצה	מעשאַעל־אייצע
משביע	מאַשביִע
משבת־לשבת	מישאַבעס־לעשאַבעס
משגיח	מאַשגיִעך
משגיחים	מאַשגיכים
משדך	מעשאַדעך
משה	מוישע
משה רבנו	מוישע ראַביינע
משה רבנוס	מוישע ראַביינעס
משהו	מאַשעהו
משהלע	מוישעלע
משהלען	מוישעלען
משהלעס	מוישעלעס
משהן	מוישען
משהס	מוישעס
משוגע	מעשוגע
משוגע־לדבֿר־אחד	מעשוגע־לעדאָווער־עכעד
משוגעים	מעשוגאָיִם
משוגען	מעשוגן
משוגענע	מעשוגענע
משוגענער	מעשוגענער
משוגענערהייט	מעשוגענערהייט
משוגעת	מעשוגאַס
משווה	מאַשווע
משולח	מעשולעך
משולחים	מעשולאָכים
משולחת	מעשולאַכעס
משולם	מעשולעם
משולש	מעשולעש
משולשים	מעשולאָשים
משום	מישום
משום־דרכּי־השלום	מישום־דאַרקע־האַשאָלעם
משום־מראית־עין	מישום־מאַריס־אַיִן
משומד	מעשומעד
משומדים	מעשומאָדים
משומדת	מעשומעדעס
משומדתטע	מעשומעדעסטע
משונה	מעשונע
משועבד	מעשובעד
משועבדי־קהל	מעשובאָדע־קאָאָל
משופּע	מעשופּע
משופֿרי־דשופֿרי	מעשופֿרע־דעשופֿרע
משורר	מעשוירער
משוררים	מעשאָרערים
משחד	מעשאַכעד
משחית	מאַשכעס
משחיתים	מאַשכיסים
משיבֿ	מיישעוו
משיבֿ־שלום	מיישעוו־שאָלעם
משיח	מעשיִעך
משיח בן־דוד	מעשיִעך בען־דאָוויד
משיח בן־יוסף	מעשיִעך בען־יויסעף
משיחות	מעשיכעס
משיחים	מעשיכים
משיחיש	מעשיכיש
משיחל	מעשיִעכל
משיחן	מעשיִעכן
משיחס	מעשיִעכס
משכּון	מאַשקן
משכּונות	מאַשקאָנעס
משכּנתּא	מאַשקאַנטע,מישקאַנטע
משך	מעשעך
משכמו־ומעלה	מישיכמע־וואָמײַלע
משל	מאָשל
משל־כּחרס־הנישבר	מאָשל־קעכערעס־האַנישבער
משלוח־מנות	מישלויעך־מאָנעס
משלח	מעשאַלייעך
משלחת	מישלאַכעס
משלי	מישלע
משלים	מאַשלעם,מעשאָלים
משליש	מאַשלעש
משלם	מעשאַלעם
משלמען	מעשאַלעמען
משלנו	מישעלאָנו
משלשל־ביד	מעשאַלשל־בעיאַד
משמורת	מישמוירעס
משמע	מאַשמע
משמעות	מאַשמאָעס
משמר־ומציל	מעשאַמער־אומאַצל
משמש	מעשאַמעש
משמש־המיטה	מעשאַמעש־האַמיטע
משמשים	מעשאַמשים
משנה	מישנע,מעשאַנע
משנה־שם	מעשאַנע־שעם
משניות	מישנײַעס
משניותן	מישנײַעסן
משנים־קדמוניות	מישאָנים־קאַדמויניעס
משנכנס אָדר	מישעניכנעס אָדער
משער	מעשאַער
משעשע	מעשײַשייע
משפּחה	מישפּאָכע
משפּחהדיק	מישפּאָכעדיק
משפּחהדיקן	מישפּאָכעדיקן
משפּחהדיקס	מישפּאָכעדיקס
משפּחהדיקע	מישפּאָכעדיקע
משפּחהדיקער	מישפּאָכעדיקער
משפּחות	מישפּאָכעס
משפּחטע	מישפּאַכטע
משפּחטעס	מישפּאַכטעס
משפּחטערע	מישפּאַכטערע
משפּחטערעס	מישפּאַכטערעס
משפּטים	מישפּאָטים
משפּיל	מאַשפּל
משפּיע	מאַשפּיִע
משקאָות	מאַשקאָעס
משקה	מאַשקע
משקולת	מישקוילעס
משקר	מעשאַקער
משרת	מישוראַס,מעשאָרעס
משרתטע	מעשאָרעסטע
משרתים	מעשאָרסים
משרתיש	מעשאָרסיש
מששת־ימי־בראשית	מישיישעס־יעמיי־בריישעס
משתּדל	מישטאַדל
משתּטח	מישטאַטייעך
משתּין	מאַשטן
משתּתּף	מישטאַטעף
משׂא	מאַסע
משׂא־כּבֿדה	מאַסע־קוויידע
משׂא־מתּן	מאַסעמאַטן
משׂא־פּנים	מאַסעפּאָנעם
משׂאָות	מאַסאָעס
משׂטין	מאַסטן
משׂיג	מאַסעג
משׂינאת־המן	מעסינעס־האָמען
משׂכּיל	מאַסקל
משׂכּילים	מאַסקילים
משׂכּיליש	מאַסקיליש
משׂכּילישן	מאַסקילישן
משׂכּילישע	מאַסקילישע
משׂכּילישער	מאַסקילישער
משׂמח	מעסאַמייעך
מתּוך	מיטאָך
מתּוך־המעשׂה	מיטאָך־האַמײַסע
מתּוך־שׂחוק	מיטאָך־סכאָק
מתּיר	מאַטער
מתּיר־דם	מאַטער־דאַם
מתּיר־נדר	מאַטער־ניידער
מתּמר־ועולה	מיטאַמער־וועוילע
מתּן־בסתר	מאַטן־בעסייסער
מתּן־תּורה	מאַטן־טוירע
מתּנה	מאַטאָנע
מתּנות	מאַטאָנעס
מתּנת־אלוהים	מאַטנעס־עלויהים,מאַטנעס־עלויקים
מתּנת־בשׂר־ודם	מאַטנעס־באָסער־וועדאָם
מתּנת־חינם	מאַטנעס־כינעם
מתּנת־יד	מאַטנעס־יאַד
מתּת	מאַטעס
מתּתיהו	מאַטעסיאָהו
מתּתיהוס	מאַטעסיאָהוס
מת	מעס
מת־טהור	מעס־טאָהער
מת־מיצווה	מעס־מיצווע
מתאַסף	מיסאַסעף
מתבודד	מיסבוידעד
מתבונן	מיסבוינען
מתגבר	מיסגאַבער
מתדבק	מיסדאַבעק
מתוודה	מיסוואַדע
מתווכּח	מיסוואַקייעך
מתון	מאָסן
מתונים	מעסונים
מתושלח	מעסושעלעך
מתחבר	מיסכאַבער
מתחייבֿ	מיסכײַעוו
מתחייבֿ־בנפֿשו	מיסכײַעוו־בענאַפֿשע
מתחכּם	מיסכאַקעם
מתחנן	מיסכאַנען
מתחתּן	מיסכאַטן
מתי־מידבר	מייסע־מידבער
מתי־מיצווה	מייסע־מיצווע
מתיאש	מיסיאַעש
מתיבֿתּא	מעסיפֿטע
מתיחד	מיסיאַכעד
מתיחס	מיסיאַכעס
מתים	מייסים
מתינות	מעסינעס
מתיעץ	מיסיאַעץ
מתיקות	מעסיקעס
מתיקותדיק	מעסיקעסדיק
מתיקותדיקן	מעסיקעסדיקן
מתיקותדיקס	מעסיקעסדיקס
מתיקותדיקע	מעסיקעסדיקע
מתיקותדיקער	מעסיקעסדיקער
מתכוון	מיסכאַוון
מתמיד	מאַסמעד
מתמידה	מאַסמידע
מתמידים	מאַסמידים
מתן	מעסן
מתנגד	מיסנאַגעד
מתנגדות	מיסנאַגדעס
מתנגדים	מיסנאַגדים
מתנגדיש	מיסנאַגדיש
מתנגדישן	מיסנאַגדישן
מתנגדישע	מיסנאַגדישע
מתנגדישער	מיסנאַגדישער
מתנה	מאַסנע
מתנצל	מיסנאַצל
מתעורר	מיסוירער
מתעסק	מיסאַסעק
מתעסק־במיצוות	מיסאַסעק־בעמיצוועס
מתעסק־בצרכי־ציבור	מיסאַסעק־בעצאָרכע־ציבער
מתעסקים	מיסאַסקים
מתעסקים־במיצוות	מיסאַסקים־בעמיצוועס
מתעסקים־בצרכי־ציבור	מיסאַסקים־בעצאָרכע־ציבער
מתפּלל	מיספּאַלעל
מתקן	מעסאַקן
מתקנא	מיסקאַנע
מתרה	מאַסרע
מתרחק	מיסראַכעק
מתרעם	מיסראַעם
מתרץ	מעסאַרעץ
נ	נון
נאה	נאָע
נאה־דורש	נאָע־דוירעש
נאה־מקיים	נאָע־מעקײַעם
נאָכטעם	נאָכטאַם
נאמן	נעמען
נאמנה	נעמאָנע
נאמנות	נעמאָנעס
נאמנטע	נעמענטע
נאמנטעס	נעמענטעס
נאמנים	נעמאָנים
נבֿואה	נעוווּע
נבֿוכדנאצר	נעוווּכאַדנעצער
נבֿוכדנצר	נעוווּכאַדנעצער
נבֿיא	נאָווי
נבֿיאה	נעוויִע
נבֿיאהטע	נעוויִעטע
נבֿיאהטעס	נעוויִעטעס
נבֿיאות	נעוויִעס
נבֿיאים	נעוויִיִם
נבֿיאים־אַחרונים	נעוויִיִם־אַכרוינים
נבֿיאים־וכּתובֿים	נעוויִיִם־אוקסוּווים
נבֿיאים־ראשונים	נעוויִיִם־רישוינים
נבֿיאיש	נעוויִיִש
נבֿלה	נעוואָלע,נעוויילע
נבֿלות	נעוויילעס
נגבֿ	נעגעוו
נגיד	נאָגעד
נגידה	נעגידע
נגידות	נעגידעס
נגידים	נעגידים
נגידיש	נעגידיש
נגידישן	נעגידישן
נגידישע	נעגידישע
נגידישער	נעגידישער
נגידישקייט	נעגידישקייט
נגידיתטע	נעגידעסטע
נגידיתטעס	נעגידעסטעס
נגידס	נאָגעדס
נגינה	נעגינע
נגישות	נעגישעס
נגע	נעגע
נגע־צרעת	נעגע־צאָראַאַס
נגעים	נעגאָיִם
נגען	נעגען
נגענען	נעגענען
נדבֿה	נעדאָווע
נדבֿות	נעדאָוועס
נדבֿן	נאַדוון
נדבֿנות	נאַדוואָנעס
נדבֿנטע	נאַדוונטע
נדבֿנים	נאַדוואָנים
נדוניא	נעדוניע
נדיבֿ	נאָדעוו
נדיבֿ־הידוע	נאָדעוו־האַיעדוע
נדיבֿים	נעדיווים
נדן	נאַדן,נעדאַן
נדר	ניידער
נדרים	נעדאָרים
נהנה	נעהענע
נהנה־מיגיע־כּפּו	נעהענע־מיגיִע־קאַפּע
נהר־די־נור	נעהאַר־די־נור
נהראָ נהראָ ופֿשטי	נאַהאַראָ נאַהאַראָ אופֿשאָטע
נהרג	נערעג
נהרג־על־פּחות־משווה־פּרוטה	נערעג־אַל־פּאָכעס־מישאָווע־פּרוטע
נהרגן	נערעגן
נואף	נויעף
נואפֿטע	נויעפֿטע
נואפֿים	נאָיאַפֿים,נויעפֿים
נואפֿן	נויעפֿן
נוגע	נעגייע
נוגע־בדבֿר	נעגייע־באַדאָווער
נוגע־בכּבֿוד	נעגייע־בעקאָוועד
נוגשׂ	נויגעס
נוגשׂים	נויגסים,נויקסים
נוהג	נויעג
נוהג־כּבֿוד	נויעג־קאָוועד
נוח־לבריות	נויעך־לעבריִעס
נוטה	נויטע
נוטה־למות	נויטע־לאָמעס
נוטים־למות	נויטים־לאָמעס
נוטריקון	נוטריקן
נולד	נוילעד
נולד־מהול	נוילעד־מאָהעל
נולדים	נאָלדים
נון	נון
נוסח	נוסעך
נוסח־אַשכּנז	נוסעך־אַשקענאַז
נוסח־האַר״י	נוסעך־האָאַרי
נוסח־ספֿרד	נוסעך־ספֿאַרד
נוסחאָות	נוסכאָעס
נוסע	נעסייע
נוסעים	נויסים
נופֿך	נויפֿעך
נופֿך־משלה	נויפֿעך־מישעלאָ
נופֿך־משלו	נויפֿעך־מישעלוי
נוצרי	נויצרי
נוקם	נויקעם
נוקם־ונוטר	נויקעם־ווענויטער
נוקם־ונוטר־כּנחש	נויקעם־ווענויטער־קענאָכעש
נושׂא־חן	נויסע־כיין
נושׂא־כּלים	נויסע־קיילים
נושׂא־פּנים	נויסע־פּאָנעם
נושׂאי־המיטה	נויסע־האַמיטע
נושׂאים	נויסים
נותן	נויסן
נותנים	נאָסנים
נותנען	נויסענען
נזיפֿה	נעזיפֿע
נזיקין	נעזיקן
נזיר	נאָזער
נזירות	נעזירעס
נזירים	נעזירים
נח	נויעך
נחבא־אל־הכּלים	נעכבע־על־האַקיילים
נחום	נאָכעם
נחות־דרגא	כאָס־דאַרגע,נעכאָס־דאַרגע
נחזור לענינינו	נאַכזער לעיִניאָניינו
נחלאָות	נאַכלאָעס
נחלה	נאַכלע
נחמה	נעכאָמע,נעכאַמע
נחמהן	נעכאָמען,נעכאַמען
נחמהס	נעכאָמעס,נעכאַמעס
נחמות	נעכאָמעס
נחמיה	נעכעמיע
נחמיהן	נעכעמיען
נחמיהס	נעכעמיעס
נחמן	נאַכמען
נחן	נויעכן
נחס	נויעכס
נחש	נאָכעש
נחש־הקדמוני	נאָכעש־האַקאַדמויני
נחשים	נעכאָשים
נחת	נאַכעס
נחת־רוח	נאַכעס־רועך
נטיה	נעטיִע
נטיות	נעטיִעס
נטילת־ידים	נעטילעס־יעדאַיִם
נ״י	ניירע־יאָער
ניאוף	ניִעף
ניבול־פּה	ניבלפּע
ניבֿהל־ומשתּומם	ניוול־אומישטוימעם
ניבֿהל־ונשתּומם	ניוול־ווענישטוימעם
ניבֿזה	ניווזע
ניבֿזים	ניווזים
ניבֿחר	ניווכער,ניפֿכער
ניבֿחרים	ניווכאָרים,ניפֿכאָרים
ניגון	ניגן
ניגונדל	ניגנדל
ניגונים	ניגונים
ניגונימלעך	ניגונימלעך
ניגזל	ניגזל
ניגזלים	ניגזאָלים
ניגזר	ניגזער
ניגלה	ניגלע
ניגמר	ניגמער
נידה	נידה
נידחה	ניטכע
ניזהר	ניזער
ניזוק	ניזעק
ניזוקן	ניזעקן
ניחא	ניכע
ניחותא	ניכעסע
ניכּר	ניקער
ניכבד	ניכבעד
ניכבדי־העיר	ניכבאָדע־האָיִר
ניכבדים	ניכבאָדים
ניכלל	ניכלעל
ניכנע	ניכנע
ניכנעים	ניכנאָיִם
ניכפּה	ניכפּע
ניכפּהניצע	ניכפּעניצע
ניכפּהניק	ניכפּעניק
ניכשל	ניכשל
ניכתּבֿ	ניכטעוו
ניכתּבֿים	ניכטאָווים
נימאס	נימעס
נימאס־ומאָוס	נימעס־אומאָעס
נימאס־ומיאוס	נימעס־אומיִעס
נימוס	נימעס
נימוסים	נימוסים
נימצא	נימצע
נימשל	נימשל
נימשלים	נימשאָלים
ניסן	ניסן
ניסתּר	ניסטער
ניסתּרות	ניסטאָרעס
ניסתּרים	ניסטאָרים
ניפֿטר	ניפֿטער
ניפֿטרים	ניפֿטאָרים
ניפֿלא	ניפֿלע
ניצול	ניצל
ניצוץ	ניצעץ
ניצוצות	ניצויצעס
ניצמח	ניצמעך
ניצרך	ניצרעך
ניצרכים	ניצראָכים
ניקוד	ניקעד
נירדף	נירדעף
נירדפֿים	נירדאָפֿים
נישאר	נישער
נישקשה	נישקאָשע
נישקשהדיק	נישקאָשעדיק
נישקשהדיקן	נישקאָשעדיקן
נישקשהדיקס	נישקאָשעדיקס
נישקשהדיקע	נישקאָשעדיקע
נישקשהדיקער	נישקאָשעדיקער
נישׂרף	ניסרעף
נישׂרפֿים	ניסראָפֿים
ניתּבע	ניטבע
ניתּבעים	ניטבאָיִם
נ״ך	נאַך
נכסים	נעכאָסים
נמרוד	נימרעד
ננתּקה	נענאַטקע
נס	נעס
נס גדול היה שם	נעס גאָדויל הויאָ שאָם,נעס גאָדל הויאָ שאָם
נס־בתּוך־נס	נעס־בעטאָך־נעס
נס־מן־השמים	נעס־מין־האַשאָמאַיִם
נסי־נסים	ניסע־ניסים
נסיון	ניסויען
נסיונות	ניסיוינעס
נסים	ניסים
נסים־ונפֿלאָות	ניסים־וועניפֿלאָעס
נסימדיק	ניסימדיק
נסיעה	נעסיִע
נסיעות	נעסיִעס
נסך	נעסעך
נסתּלק	ניסטאַלעק
נע־ונד	נאַווענאַד
נע־ונדניצע	נאַווענאַדניצע
נע־ונדניק	נאַווענאַדניק
נעילה	נילע
נעימותדיק	נעיִמעסדיק
נעלם	נעלם
נעלמים	נעלאָמים
נעמי	נאַמע,נאָמע,נוימע
נענועים	נינויִם
נענש	נענעש
נעצר	נעצער
נערה־המאורשׂה	נאַרע־האַמויראָסע
נערה־שניתפּתּתה	נאַרע־שעניספּאַטעסע
נעשׂה־ונשמע	נײַסע־ווענישמע
נפֿיחה	נעפֿיכע
נפֿלע	נייפֿעלע
נפֿקא	נאַפֿקע
נפֿקא־מינה	נאַפֿקעמינע
נפֿש	נעפֿעש
נפֿש־אַחת	נעפֿעש־אַכעס
נפֿשות	נעפֿאַשעס,נעפֿאָשעס
נפֿתּלי	נאַפֿטאָלע
נפֿתּלין	נאַפֿטאָלען
נפֿתּליס	נאַפֿטאָלעס
נצבֿים	ניצאָווים
נצח	נעצעך
נצח־ישׂראל	נעצעך־ייִסראָעל
נצחון	ניצאָכן
נצחונות	ניצכוינעס
נצחנות	נאַצכאָנעס
נצרת	נאַצערעס
נקבֿה	נעקייווע
נקבֿות	נאַקוועס,נעקייוועס
נקבֿים	נעקאָווים
נקבֿים־גדולים	נעקאָווים־גדוילים
נקבֿים־קטנים	נעקאָווים־קטאַנים
נקודה	נעקודע
נקודות	נעקודעס
נקודים־ובֿרודים	נעקודים־אוּוורודים
נקי	נאָקי
נקי־כּפּים	נעקי־קאַפּאַיִם
נקי־כּפּימניק	נעקי־קאַפּאַיִמניק
נקיות	נעקיִעס
נקמה	נעקאָמע
נר	נייר
נר־תּמיד	ניירטאָמעד
נרו־יאיר	ניירע־יאָער
נשים	נאָשים
נשים־וטף	נאָשים־וועטאַף
נשים־צדקניות	נאָשים־ציטקאָניעס
נשים־צנועות	נאָשים־צנועס
נשמה	נעשאָמע
נשמה־יתירה	נעשאָמע־יעסיירע
נשמה־ליכט	נעשאָמע־ליכט
נשמות	נעשאָמעס
נשמתו בגנזי־מרומים	נישמאָסע בעגינזע־מערוימים
נשתּומם	נישטוימעם
נשתּנה	נישטאַנע
נשׂא	נאָסאָ
נשׂיא	נאָסי
נשׂיאים	נעסיִיִם
נתבקש	ניסבאַקעש
נתגדל	ניסגאַדל
נתגלה	ניסגאַלע
נתחייבֿ	ניסכײַעוו
נתחמץ	ניסכאַמעץ
נתינה	נעסינע
נתן	נאָסן
נתנה־תּוקף	נעסאַנע־טויקעף
נתנען	נאַסענען
נתעלה	ניסאַלע
נתעשר	ניסאַשער
נתפּעל	ניספּאָעל
נתפּרסם	ניספּאַרסעם
נתרבה	ניסראַבע
ס	סאַמעך
סבֿא	סאָווע
סבֿיבֿה	סוויווע
סבֿיבֿות	סוויוועס
סבֿלן	סאַוולען
סבֿלנות	סאַוולאָנעס
סבֿלנטע	סאַוולענטע
סבֿלנטעס	סאַוולענטעס
סבֿלנים	סאַוולאָנים
סבֿרא	סוואָרע
סבֿרה	סוואָרע
סגול	סעגל
סגולה	זגולע
סגולות	זגולעס
סגי־נהור	סאַגענאָער,סעגינאָער
סגי־נהורדיק	סעגינאָערדיק
סגי־נהורטע	סאַגענאָערטע,סעגינאָערטע
סג״ל	סעגאַל
סגן־לויה	סגאַן־לעוויִע
סדום	סדאָם
סדום־בעטל	סדאָם־בעטל
סדום־ועמורה	סדאָם־וואַאַמוירע
סדום־מישפּט	סדאָם־מישפּעט
סדר	סיידער
סדר־היום	סיידער־האַיאָם
סדר־העולם	סיידער־האָוילעם
סדר־עולם	סיידער־אוילעם
סדרה	סעדרע
סדרות	סעדרעס
סדרי־בראשית	סידרע־בריישעס
סדרים	סדאָרים,סעדאָרים
סדרן	סאַדערן,סיידערן
סובֿל	סויוול
סוג	סוג
סוגיא	סוגיע
סוגיות	סוגיעס
סוגרן	סויגערן
סוד	סאָד
סודות	סוידעס
סודות־התּורה	סוידעס־האַטוירע
סודותדיק	סוידעסדיק
סודותדיקן	סוידעסדיקן
סודותדיקס	סוידעסדיקס
סודותדיקע	סוידעסדיקע
סודותדיקער	סוידעסדיקער
סודי־סודות	סאָדע־סוידעס
סודע	סוידע
סודעט	סוידעט
סודען	סוידען
סודעסט	סוידעסט
סוחר	סויכער
סוחרטע	סויכערטע
סוחרטעס	סויכערטעס
סוחרים	סאָכרים
סוחרימלעך	סאָכרימלעך
סוחריש	סאָכריש
סוחרל	סויכערל
סוחרס	סויכערס
סוחרערײַ	סאָכרערײַ
סוטה	סויטע
סוכּה	סוקע
סוכּה־שער	סוקע־שער
סוכּות	סוקעס
סוכנותּ	סאָכנוט
סולת	סוילעס
סומך	סוימעך
סומך־נופֿלים	סוימעך־נאָפֿלים
סוס	סוס
סוף	סאָף
סוף־	סאָף
סוף־כּל־הדורות	סאָף־קאָל־האַדוירעס
סוף־כּל־סוף	סאָפֿקל־סאָף
סופֿר	סויפֿער
סופֿר־מהיר	סויפֿער־מאָהער
סופֿר־סתּ״ם	סויפֿער־סטאַם
סופֿרות	סאָפֿרעס
סופֿרים	סאָפֿרים
סופֿריש	סאָפֿריש
סופֿרס	סויפֿערס
סותר	סויסער
סחורה	סכוירע
סחורות	סכוירעס
סיבה	סיבע
סיבות	סיבעס
סיגוף	סיגעף
סיגופֿים	סיגופֿים
סיגנון	סיגנען
סידור	סידער
סידור־קידושין	סידער־קידושן
סידורים	סידורים
סידורימלעך	סידורימלעך
סידורל	סידערל
סיוון	סיוון
סיום	סיִעם
סיטרא־אַחרא	סיטרע־אַכרע
סיטרא־בישא	סיטרע־בישע
סיטרא־דשׂמאָלא	סיטרע־דיסמאָלע
סיטרא־מסאָבֿותא	סיטרע־מעסאָוווּסע
סיכסוך	סיכסעך
סיכסוכים	סיכסוכים
סילוק	סילעק
סילוקים	סילוקים
סילוקן	סילעקן
סימן	סימען
סימן־דלות	סימען־דאַלעס
סימן־דצ״ך	סימען־דעצאַך
סימן־טובֿ	סימענטאָוו
סימן־מובֿהק	סימען־מוּוועק
סימני־זכרות	סימאָנע־זאַכרעס
סימני־נערות	סימאָנע־נאַאַרעס
סימנים	סימאָנים
סימנים־מובֿהקים	סימאָנים־מוּוואָקים
סיני	סינײַ
סיני סנסיני סמנגלוף	סינע סאַנסינע סעמאַנגלאָף
סיני־ניגון	סינײַ־ניגן
סיני־ניגונים	סינײַ־ניגונים
סינידיק	סינײַדיק
סיעתּא־דשמעיא	סיִאַטע־דעשמײַע
סיפּור	סיפּער
סיפּור־המעשׂה	סיפּער־האַמײַסע
סיפּור־ניפֿלא	סיפּער־ניפֿלע
סיפּורי־מעשׂיות	סיפּורע־מײַסעס
סיפּורי־נפֿלאָות	סיפּורע־ניפֿלאָעס
סיפּורים	סיפּורים
סיר־הבשׂר	סיר־האַבאָסער
סירכא	סירכע
סיתרי־תּורה	סיסרע־טוירע
סכּין	סאַקן
סכּנה	סאַקאָנע,סעקאָנע
סכּנות	סאַקאָנעס,סעקאָנעס
סכּנות־נפֿשות	סאַקאָנעס־נעפֿאָשעס,סעקאָנעס־נעפֿאָשעס
סך	סאַך
סך־הכּולל	סאַך־האַקוילעל
סך־הכּל	סאַכאַקל,סכאַקל,סעכאַקל
סכום	סכום
סכום־הכּולל	סכום־האַקוילעל
סכך	סכאַך
סליחה	סליכע
סליחה־ומחילה	סליכע־אומעכילע
סליחהנען	סליכענען
סליחהנער	סליכענער
סליחות	סליכעס
סלע־המחלוקת	סעלע־האַמאַכלויקעס
סלקא דעתּך	סאָלקאָ דייטאָך
ס״ם	סאַם,סאַמעך־מעם
סם	סאַם
סם־המוות	סאַם־אַמאָוועס,סאַם־האַמאָוועס
סמאל	סאַמאָעל
סמבטיון	סאַמבאַטיען
סמיכה	סמיכע
סמיכות	סמיכעס
סמיכות־הפּרשה	סמיכעס־האַפּאַרשע
סמיכות־הפּרשיות	סמיכעס־האַפּאַרשעס
סמך	סאַמעך,סמאַך,סעמאַך,סעמעך
סמך־מם	סאַמעך־מעם
סמנגלוף	סעמאַנגלאָף
סמען	סאַמען
סנדלפֿון	סאַנדאַלפֿן
סנדק	סאַנדעק
סנדקאָות	סאַנדעקאָעס
סנה	סנע
סנהדרין	סאַנעדרין
סנהדרין־גדולה	סאַנעדרין־גדוילע
סנהדרין־קטנה	סאַנעדרין־קטאַנע
סנוי סנסנוי סמנגלוף	סענוי סאַנסענוי סעמאַנגלאָף
סניגור	סאַנייגער
סעדיה	סאַדיע
סעדיה גאון	סאַדיע גאָען
סעדיה הגאון	סאַדיע האַגאָען
סעודה	סודע
סעודה־המפֿסקת	סודע־האַמאַפֿסעקעס
סעודות	סודעס
סעודת־הבֿראה	סודעס־האַווראָע
סעודת־מיצווה	סודעס־מיצווע
סעודת־פּורים	סודעס־פּורים
סעיף	סאָיִף
סעיפֿים	סעיִפֿים
ספֿירה	ספֿירע
ספֿירות	ספֿירעס
ספֿירת־הנוצרים	ספֿירעס־האַנאָצרים
ספֿק	סאָפֿעק
ספֿק־ספֿקא	ספֿעק־ספֿייקע
ספֿקות	ספֿייקעס
ספֿקן	סאָפֿעקן
ספֿר	סייפֿער
ספֿר־הזכרונות	סייפֿער־האַזיכרוינעס
ספֿר־החיים	סייפֿער־האַכאַיִם
ספֿר־החתום	סייפֿער־האַכאָסעם
ספֿר־הישר	סייפֿער־האַיאָשער
ספֿר־הספֿרים	סייפֿער־האַספֿאָרים
ספֿר־חול	סייפֿער־כויל
ספֿר־חקירה	סייפֿער־כקירע
ספֿר־יצירה	סייפֿער־יעצירע
ספֿר־פּראַלניק	סייפֿער־פּראַלניק
ספֿר־רזיאל	סייפֿער־ראַזיל,סייפֿער־ראַזיִעל
ספֿר־רזיאל המלאך	סייפֿער־ראַזיל האַמאַלעך,סייפֿער־ראַזיִעל האַמאַלעך
ספֿר־תּורה	סייפֿער־טוירע
ספֿרא־רבה	סאַפֿרע־ראַבע
ספֿרד	ספֿאַרד
ספֿרדי	ספֿאַרדי
ספֿרדיש	ספֿאַרדיש
ספֿרדית	ספֿאַרדיס
ספֿרי־חול	סיפֿרע־כויל
ספֿרי־חקירה	סיפֿרע־כקירע
ספֿרי־תּורה	סיפֿרע־טוירע
ספֿרים	ספֿאָרים
ספֿרים־חיצונים	ספֿאָרים־כיצוינים
סקילה	סקילע
סרחה	סראָכע
סרחן	סאַרכן
סרחנים	סאַרכאָנים
סרחען	סאַרכען
סרחענען	סאַרכענען
סרטן	סאַרטן
סריס	סאָרעס
סריסות	סריסעס
סריסים	סריסים
סרסור	סאַרסער
סרסורים	סאַרסאָרים
סרסורן	סאַרסערן
סתּימת־הגולל	סטימעס־האַגוילעל
סתּירה	סטירע
סתּירות	סטירעס
סתּ״ם	סטאַם
סתּם	סטאַם
ע	אײַען
עבֿד	עוועד
עבֿד־כּנעני	עוועד־קנאַאַני,עוועד־קנײַני
עבֿדות	אַוודעס
עבֿדיה	אָוואַדיע
עבֿדים	אַוואָדים
עבֿדים־היינו	אַוואָדים־האָיִנו
עבֿדים־כּנענים	אַוואָדים־קנאַאַנים,אַוואָדים־קנײַנים
עבֿודה	אַוווידע
עבֿודה־בזויה	אַוווידע־בזוּיע
עבֿודה־זרה	אַוווידע־זאָרע
עבֿודה־זרהס	אַוווידע־זאָרעס
עבֿודות	אַוווידעס
עבֿודות־בזויות	אַוווידעס־בזוּיעס
עבֿודת־הבורא	אַוווידעס־האַבוירע
עבֿודת־הקודש	אַוווידעס־האַקוידעש
עבֿודת־השם	אַוווידעס־האַשעם
עבֿודת־פּרך	אַוווידעס־פּערעך
עבֿירה	אַוויירע,נעוויירע
עבֿירות	אַוויירעס,נעוויירעס
עבֿירות שבין־אָדם־לחבֿרו	אַוויירעס שעביין־אָדעם־לעכאַוויירע
עבֿירות שבין־אָדם־למקום	אַוויירעס שעביין־אָדעם־לאַמאָקעם
עבֿר	אָווער
עבֿר־ובֿטל	אויווער־אוּוואָטל
עבֿר־זמן	אָווער־זמאַן
עבֿרי	איוורע
עבֿרי־טײַטש	איוורע־טײַטש
עבֿריתּ	איווריט
עגון	אָגן
עגונה	אַגונע
עגונות	אַגונעס
עגונים	אַגונים
עגל	אייגל
עגל־הזהבֿ	אייגל־האַזאָהעוו
עגלה	אַגאָלע
עגלה־ערופֿה	עגלע־אַרופֿע
עגלות	אַגאָלעס
עגמת־נפֿש	אַגמעס־נעפֿעש
עגמת־נפֿשן	אַגמעס־נעפֿעשן
עד	אַד,אייד
עד־בלי־די	אַד־בלי־דײַ,אַד־בעלי־דײַ
עד־גמירא	אַד־גמירע
עד־היום	אַד־הײַעם,אַדײַעם
עד־היום־הזה	אַד־האַיאָם־האַזע
עד־חצי־המלכות	אַד־כאַצי־האַמאַלכעס
עד־חרמה	אַד־כאָרמע
עד־יעבֿור־זעם	אַד־יאַאַווויר־זאַאַם
עד־כּאַן	אַד־קאַן
עד־כּאַן אומרים בשבת־הגדול	אַד־קאַן אָמרים בעשאַבעס־האַגאָדל
עד־כּיכּר־לחם	אַד־קיקער־לעכעם
עד־לבֿ־השמים	אַד־לעוו־האַשאָמאַיִם
עד־לבֿ־שמים	אַד־לעוו־שאָמאַיִם
עד־לחשבון	אַד־לעכעזשבם,אַד־לעכעזשבן
עד־לפּ״ק	אַד־לאַפּאַק
עד־לפּרוטה־קטנה	אַד־ליפּרוטע־קטאַנע
עד־לפּרט־קטן	אַד־ליפּראַט־קאָטן
עד־לשמים	אַד־לאַשאָמאַיִם
עד־מאה־ועשׂרים	אַד־מייע־וועעסרים
עד־מאה־ועשׂרים־שנה	אַד־מייע־וועעסרים־שאָנע
עד־מפּי־עד	אייד־מיפּי־אייד
עד־מתי	אַד־מאָסײַ
עד־סוף־כּל־הדורות	אַד־סאָף־קאָלהאַדוירעס
עד־ראיה	אייד־ריִע
עדה	איידע
עדויות	איידוּיעס
עדות	איידעס
עדותט	איידעסט
עדותטע	איידעסטע
עדותטעס	איידעסטעס
עדותן	איידעסן
עדותנדיק	איידעסנדיק
עדותשאַפֿט	איידעסשאַפֿט
עדותשאַפֿטן	איידעסשאַפֿטן
עדי־ראיה	איידע־ריִע
עדים	איידים
עובר	אובער
עוברים	אובאָרים
עובֿד־כּוכבֿים־ומזלות	אויוועד־קויכאָווים־אומאַזאָלעס
עובֿדא	אוּוודע
עובֿדה	אוּוודע
עובֿדות	אוּוודעס
עובֿדי־כּוכבֿים־ומזלות	אָוודע־קויכאָווים־אומאַזאָלעס
עובֿר	אויווער
עובֿר־בטל	אויווערבאָטל
עובֿר־בטלן	אויווערבאָטעלן
עובֿר־בטלניצע	אויווערבאָטלניצע
עובֿר־בטלניצעס	אויווערבאָטלניצעס
עובֿר־בטלניק	אויווערבאָטלניק
עובֿר־בטלניקעס	אויווערבאָטלניקעס
עובֿר־בטלס	אויווערבאָטלס
עובֿר־בטלע	אויווערבאָטעלע
עובֿר־בטלער	אויווערבאָטעלער
עובֿר־לסוחר	אויווער־לעסויכער
עובֿר־על־דת	אויווער־אַל־דאַס
עובֿר־קריאת־שמע	אויווער־קרישמע
עובֿר־שבֿועה	אויווער־שוווּע
עוג־מלך־הבשן	אָג־מיילעך־האַבאָשן
עודף	אוידעף
עוולה	אַוולע
עוולות	אַוולעס
עוון	אָוון
עוונות	אַוווינעס
עוזר	אויזער
עוזרל	אויזערל
עוזרן	אויזערן
עוזרס	אויזערס
עוכר־ישׂראל	אויכער־ייִסראָעל
עול	אָל
עול־מלכות־שמים	אָל־מאַלכעס־שאָמאַיִם
עול־פּרנסה	אָל־פּאַרנאָסע
עולה	אוילע
עולה־יפֿה	אוילע־יאָפֿע
עולה־לגדולה	אוילע־ליגדולע
עולה־לתּורה	אוילע־לאַטוירע
עולה־רגל	אוילע־רעגל
עולה־תּמימה	אוילע־טמימע
עולות	אוילעס
עולים	אוילים
עולם	אוילעם
עולם־גולם	אוילעם־גוילעם
עולם־האמת	אוילעם־האָעמעס
עולם־האַצילות	אוילעם־האָאַצילעס
עולם־הבא	אוילעם־האַבע
עולם־הדמיון	אוילעם־האַדימיען
עולם־הזה	אוילעם־האַזע
עולם־הזהניצע	אוילעם־האַזעניצע
עולם־הזהניצעס	אוילעם־האַזעניצעס
עולם־הזהניק	אוילעם־האַזעניק
עולם־הזהניקעס	אוילעם־האַזעניקעס
עולם־הזימרה	אוילעם־האַזימרע
עולם־הנגינה	אוילעם־האַנעגינע
עולם־העליון	אוילעם־האָעליען
עולם־הפֿוך	אוילעם־האָפֿעך
עולם־הצחצחות	אוילעם־האַצאַכצאָכעס
עולם־השפֿל	אוילעם־האַשאָפֿל
עולם־השקר	אוילעם־האַשעקער
עולם־התּוהו	אוילעם־האַטויע
עולם־התּחתּון	אוילעם־האַטאַכטן
עולם־ומלואו	אוילעם־אומלויע
עולם־מלא	אוילעם־מאָלע
עולם־עליון	אוילעם־עליען
עולם־קטן	אוילעם־קאָטן
עולמות	אוילאָמעס,אוילעמעס
עולמות־העליונים	אוילעמעס־האָעליוינים
עולמות־עליונים	אוילעמעס־עליוינים
עולן	אָלן
עומד־בדיבורו	אוימעד־בעדיבורע
עומד־במרדו	אוימעד־בעמירדע
עומד־בנסיון	אוימעד־בעניסויען
עומד־על־דעתּו	אוימעד־אַל־דאַטע
עומר	אוימער
עונג	אוינעג
עונג־רוחני	אוינעג־רוכני
עונג־שבת	אוינעג־שאַבעס
עונש	אוינעש
עונשים	אָנאָשים
עוסק	אויסעק
עוסק־במיצווה	אויסעק־בעמיצווע
עוסק־בצרכי־ציבור	אויסעק־בעצאָרכע־ציבער
עוסקים־במיצוות	אָסקים־בעמיצוועס
עוסקים־בצרכי־ציבור	אָסקים־בעצאָרכע־ציבער
עוף	אָף
עופֿות	אויפֿעס
עופֿות־טהורים	אויפֿעס־טעהוירים
עופֿות־טמאים	אויפֿעס־טמעיִם
עופֿעלע	אייפֿעלע
עופֿעלעך	אייפֿעלעך
עוקץ	אויקעץ
עוקצין	אוקצין
עוקר	אויקער
עוקר־הרים	אויקער־האָרים
עוקר־מן־השורש	אויקער־מין־האַשוירעש
עורבֿא פּרח	אורווע פּאָרעך
עושר	אוישער
עושרס	אוישערס
עושׂה־שלום	אויסע־שאָלעם
עושׂה־שלום־במרומיו	אויסע־שאָלעם־בימרוימאָוו
עזאזל	אַזאָזל
עזבֿון	איזאָוון
עזבֿונות	איזוווינעס
עזובֿ־תּעזובֿ	אַזויוו־טאַזויוו
עזות	אַזעס
עזות־מחוצף־פּנים	אַזעס־מעכוצעף־פּאָנעם
עזות־פּנים	אַזעס־פּאָנעם
עזות־פּנימטע	אַזעס־פּאָנעמטע
עזות־פּנימטעס	אַזעס־פּאָנעמטעס
עזות־פּנימער	אַזעס־פּענעמער
עזותדיק	אַזעסדיק
עזותדיקן	אַזעסדיקן
עזותדיקס	אַזעסדיקס
עזותדיקע	אַזעסדיקע
עזותדיקער	אַזעסדיקער
עזותקייט	אַזעסקייט
עזר־כּנגדו	אייזער־קענעגדע
עזרא	עזרע
עזרא הסופֿר	עזרע האַסויפֿער
עזראן	עזרען
עזראס	עזרעס
עזריאל	אַזריִעל
עזריאלן	אַזריִעלן
עזריאלס	אַזריִעלס
עזרת־נשים	עזרעס־נאָשים
עטרה	אַטאָרע
עטרות	אַטאָרעס
עיבור	איבער
עיבור־יאָר	איבער־יאָר
עיגול	איגל
עיגולים	איגולים
עיכּובֿ	איקעוו
עיכּובֿים	איקוּווים
עילוי	אילע
עילויים	אילויִם
עילוייִש	אילויִש
עילוייִשן	אילויִשן
עילוייִשע	אילויִשע
עילוייִשער	אילויִשער
עין	אײַען
עין תּחת עין	אַיִן טאַכעס אַיִן
עין־בעין	אַיִן־בעאַיִן
עין־הרע	איינהאָרע
עין־הרעניצע	איינהאָרעניצע
עין־הרעניצעס	איינהאָרעניצעס
עין־הרעניק	איינהאָרעניק
עין־הרעניקעס	איינהאָרעניקעס
עין־יעקבֿ	איין־יאַנקעוו
עינוי	אינע
עינויים	אינויִם
עינויים־קשים	אינויִם־קאָשים
עינים	איינאַיִם
עיפּוש	איפּעש
עיקר	איקער
עיקר־	איקער־
עיקר־המעשׂה	איקער־האַמײַסע
עיקר־העיקרים	איקער־האָיִקרים
עיקר־שכחתּי	איקער־שאָכאַכטי
עיקרים	איקרים
עיר־הבירה	איר־האַבירע
עיר־המיקלט	איר־האַמיקלעט
עיר־המלוכה	איר־האַמלוכע,איר־האַמעלוכע
עיר־ואם	איר־וועיים
עיר־ואם־בישׂראל	איר־וועיים־בעיִסראָעל
עיר־מיקלט	איר־מיקלעט
עירובֿ	איירעוו
עירובֿ־תּבֿשילין	איירעוו־טאַוושילין,איירעוו־טאַפֿשילן
עירובֿ־תּחומין	איירעוו־טכומין,איירעוו־טכומען
עירובֿים	איירוּווים
עירובֿין	איירוּוון,איירוּווין
עירובֿן	איירעוון
עכּו״ם	אַקום
עכבר	אַכבער
עכבראָש	אַכבעראָש
עכבראָשים	אַכבעראָשים
עכברים	אַכבאָרים
על	אַל
על דאַטפֿתּ אַטפֿוך	אַל דאַאַטייפֿט אַטפֿוך
על כּל צרה שלא־תבֿוא	אַל קאָל צאָרע שעלוי־סאָוווי
על ראשון ראשון ועל אַחרון אַחרון	אַל רישן רישן וועאַל אַכרען אַכרען
על־אַחת־כּמה־וכּמה	אַלאַכעס־קאַמע־וועקאַמע
על־אַפּו ועל־חמתו	אַל־אַפּע וועאַל־כאַמאָסע
על־אַפּי ועל־חמתי	אַל־אַפּי וועאַל־כאַמאָסי
על־אַפּם ועל־חמתם	אַל־אַפּעם וועאַל־כאַמאָסעם
על־דעת־	אַלדאַאַס־
על־דעת־עצמו	אַלדאַאַס־אַצמע,אַל־דאַאַס־אַצמע
על־ה׳ ועל־משיחו	אַל־האַשעם וועאַל־מעשיכע
על־הנסים	אַל־האַניסים
על־העצים ועל־האַבֿנים	אַל־האָייצים וועאַל־האָאַוואָנים
על־העצים ועל־הביצים	אַל־האָייצים וועאַל־האַבייצים
על־התּורה ועל־העבֿודה	אַל־האַטוירע וועאַל־האָאַוווידע
על־חטא	אַלכעט
על־חטא שחטאָתי	אַלכעט שעכאָטאָסי
על־חשבון	אַל־כעזשבם,אַל־כעזשבן
על־חשבונו	אַל־כעזשבוינע
על־כּל־פּנים	אַלקאָלפּאָנעם,אַלקלפּאָנעם
על־כּן	אַלקיין,אַלקן
על־מנת להחזיר	אַל־מענאַס לעהאַכזער
על־מנת לקבל פּרס	אַל־מענאַס לעקאַבל פּראַס
על־מנת שלא לקבל פּרס	אַל־מענאַס שעלוי לעקאַבל פּראַס
על־פּה	אַל־פּע
על־פּי	אַלפּי,אַל־פּי
על־פּי־גורל	אַלפּי־גוירל,אַל־פּי־גוירל
על־פּי־דין	אַלפּי־דין,אַל־פּי־דין
על־פּי־דיניהם	אַלפּי־דינייהעם,אַל־פּי־דינייהעם
על־פּי־דרך־הטבֿע	אַלפּי־דערעך־האַטעווע,אַל־פּי־דערעך־האַטעווע
על־פּי־הדחק	אַלפּי־האַטכאַק,אַל־פּי־האַטכאַק
על־פּי־חקירה	אַלפּי־כקירע,אַל־פּי־כקירע
על־פּי־טעות	אַלפּי־טאָעס,אַל־פּי־טאָעס
על־פּי־יושר	אַלפּי־יוישער,אַל־פּי־יוישער
על־פּי־מיקרה	אַלפּי־מיקרע,אַל־פּי־מיקרע
על־פּי־נס	אַלפּי־נעס,אַל־פּי־נעס
על־פּי־סבֿרה	אַלפּי־סוואָרע,אַל־פּי־סוואָרע
על־פּי־פּשט	אַלפּי־פּשאַט,אַל־פּי־פּשאַט
על־פּי־רובֿ	אַלפּי־ראָוו,אַל־פּי־ראָוו
על־פּי־רמז	אַלפּי־רעמעז,אַל־פּי־רעמעז
על־פּי־שׂכל	אַלפּי־סייכל,אַל־פּי־סייכל
על־פּרשת־דרכים	אַל־פּאָראָשעס־דראָכים
על־צד־היותר־טובֿ	אַלצאַד־האַיויסערטאָוו
על־קידוש־השם	אַלקידעש־האַשעם
על־קרן־הצבֿי	אַל־קערן־האַצווי
על־רגל־אַחת	אַל־רעגל־אַכעס
על־תּנאַי	אַלטנײַ,אַל־טנײַ
עלול	אָלעל
עלות־השחר	אַלאָס־האַשאַכער
עלי ועל צוואָרי	אָלײַ וועאַל צאַוואָרי
עליה	אַליִע,ליִע
עליה־השלום	אָלעהאַשאָלעם,אָלעשאָלעם
עליהם־השלום	אַלייעם־האַשאָלעם
עליו־השלום	אָלעוואַשאָלעם
עליו־השנאָבל	אָלעוו־האַשנאָבל
עליון	עליען
עליונים	עליוינים
עליות	אַליִעס
עליכם־ועל־בניכם	אַלייכעם־וועאַל־בנייכעם
עליכם־שלום	אַלייכעם־שאָלעם
עלילת־דם	אַלילעס־דאַם
עלילת־שוא	אַלילעס־שאָוו
עלינו	אָליינו
עלית־נשמה	אַליִעס־נעשאָמע
עלמא־דקשוט	אַלמע־דיקשויט
עם	אים,אַם
עם ישׂראל חי	אַם ייִסראָעל כײַ
עם־האָרץ	אַמאָרעץ,אַמעראַצים
עם־האָרץ־דאורײַתא	אַמאָרעץ־דעוירײַסאָ
עם־הארצות	אַמעראַצעס
עם־הארציש	אַמעראַציש
עם־הספֿר	אַם־האַסייפֿער
עם־חכם־ונבֿון	אַם־כאָכעם־ווענאָוון
עם־כּל־הנערים	אים־קאָל־האַנעאָרים
עם־קשה־עורף	אַם־קשיי־אוירעף
עמא־פּזיזא	אַמע־פּעזיזע
עמוד	אָמעד
עמוד־אש	אַמעדייש
עמוד־האש	אַמעד־האָייש
עמוד־הענן	אַמעד־העאָנען
עמוד־התּווך	אַמעד־האַטאָוועך
עמוד־ענן	אַמעד־אָנען
עמודים	אַמודים
עמון	אַמוין
עמוס	אָמעס
עמוסן	אָמעסן
עמוסעס	אָמעסעס
עמוק	אָמעק
עמך	אַמכאָ
עמלק	אַמאָלעק
עמלקים	אַמאָלייקים
עמנואל	אימאָנועל
עמנואלן	אימאָנועלן
עמנואלס	אימאָנועלס
עמק	איימעק
עמק־הבכה	איימעק־האַבאָכע
עמק־יזרעאל	איימעק־איזרעעל
עמקות	אַמקעס
עמקן	אַמקן
עמקנים	אַמקאָנים
ענוו	אָנעוו
ענווה	אַנאָווע
ענווים	אַנאָווים
עני	אָני
עני־בפּתח	אָני־באַפּעסעך
עני־הגון	אָני־האָגן
עני־ואבֿיון	אָני־וועעוויען
עני־מדוכּא	אָני־מעדוקע
עני־שבעניים	אָני־שעבאַאַניִיִם
עניוות	אַניוועס
עניות	אַניִעס
עניים	אַניִיִם
עניים־הגונים	אַניִיִם־האַגונים
עניים־ואבֿיונים	אַניִיִם־וועעוויוינים
עניים־מדוכּאָים	אַניִיִם־מעדוקאָיִם
ענין	איניען
ענינים	איניאָנים
עסק	אייסעק
עסקים	אַסאָקים
עסקן	אייסעקן,אַסקן
עסקנים	אַסקאָנים
עפֿר־ואפֿר	אָפֿער־וואָייפֿער
עפֿרא־דאַרעא	אַפֿרע־דעאַרע
עץ־הדעת	אייץ־האַדאַאַס
עץ־החיים	אייץ־האַכאַיִם
עץ־חיים	אייץ־כאַיִם
עצבֿות	אַצוועס
עצבֿותניצע	אַצוועסניצע
עצבֿותניק	אַצוועסניק
עצה	אייצע
עצה־טובֿה	אייצע־טויווע
עצהט	אייצעט
עצהן	אייצען
עצהנדיק	אייצענדיק
עצהסט	אייצעסט
עצות	אייצעס
עצים־ואילנות	אייצים־וועיִלאָנעס
עצירות	אַצירעס
עצם	עצעם
עצם־	עצעם
עצמות	אַצאָמעס
עצמות־היבֿשות	אַצאָמעס־האַיעוויישעס
עצתי	אַצאָסי
עקבֿ	אייקעוו
עקדה	אַקיידע
עקדת־יצחק	אַקיידעס־ייִצכאָק
עקודים נקודים ובֿרודים	אַקודים נעקודים אוּוורודים
עקיבֿא	אַקיווע
עקיבֿאן	אַקיווען
עקיבֿאס	אַקיוועס
עקר	אָקער
עקרבֿ	אַקרעוו
עקרה	אַקאָרע
עקרות	אַקאָרעס
עקרים	אַקאָרים
עקרען	אַקרען
עקרת־הבית	אַקערעס־האַבאַיִס
עקשן	אַקשן
עקשנות	אַקשאָנעס
עקשנותדיק	אַקשאָנעסדיק
עקשנותדיקן	אַקשאָנעסדיקן
עקשנותדיקס	אַקשאָנעסדיקס
עקשנותדיקע	אַקשאָנעסדיקע
עקשנותדיקער	אַקשאָנעסדיקער
עקשנותדיקערן	אַקשאָנעסדיקערן
עקשנותדיקערס	אַקשאָנעסדיקערס
עקשנותדיקערע	אַקשאָנעסדיקערע
עקשנותדיקערער	אַקשאָנעסדיקערער
עקשנטע	אַקשנטע
עקשנטעס	אַקשנטעס
עקשנים	אַקשאָנים
עקשנען	אַקשענען
ערבֿ	אָרעוו,ערעוו
ערבֿ־קבלן	אָרעוו־קאַבלען
ערבֿ־רבֿ	ערעווראַוו
ערבֿ־שבת	ערעוו־שאַבעס
ערבֿה	אַראָווע
ערבֿובֿיה	אירוווּוויע
ערבֿות	אָרוועס,אַרייוועס
ערבֿטע	אָרעווטע
ערבֿים	אָרווים,אַרייווים
ערבֿניצע	אָרעווניצע
ערבֿניק	אָרעווניק
ערובֿ	אָרעוו
ערוגה	אַרוגע
ערווה	ערווע
ערי־מיקלט	אָרע־מיקלעט
עריות	אַרויעס,אַרײַעס
ערכּאָות	ערקאָעס
ערך	ערעך
ערכין	אַראָכין
ערל	אָרל
ערלה	אָרלע
ערלטע	אָרלטע,ערלטע
ערלטעס	ערלטעס
ערלים	אַריילים
ערלית	אַריילעס
ערמה	אָרמע
עשיר	אָשער
עשירות	אַשירעס
עשירים	אַשירים
עשׂה	עסע
עשׂו	אייסעוו
עשׂון	אייסעוון
עשׂוס	אייסעווס
עשׂר־מכּות	עסער־מאַקעס
עשׂר־ספֿירות	עסער־ספֿירעס
עשׂרה־בטבֿת	אַסאָרע־בעטייוועס
עשׂרה־הרוגי־מלכות	אַסאָרע־האַרוגע־מאַלכעס
עשׂרה־ראשונים	אַסאָרע־רישוינים
עשׂרים־ואַרבע	סוואַרבע,עסרים־וואַרבע,עסרים־וועאַרבע
עשׂרת־בני־המן	אַסערעס־בניי־האָמען
עשׂרת־הדיברות	אַסערעס־האַדיברעס
עשׂרת־השבֿטים	אַסערעס־האַשוואָטים
עשׂרת־ימי־תּשובֿה	אַסערעס־יעמיי־טשוּווע
עתּיק־יומין	אַטעק־יוימין
עתּיקא	אַטיקע
עת־חדווה	אייס־כעדווע
עת־לעשׂות	אייס־לאַאַסויס
עת־צרה	אייס־צאָרע
עת־צרה־ליעקבֿ	אייס־צאָרע־לעיאַנקעוו
עת־רצון	אייס־ראָצן
עתיד	אָסעד
עתיד לטול את הדין	אָסעד ליטויל עס האַדין
פּ	פּיי
פּא	פּיי
פּאה	פּייע
פּאהלע	פּייעלע
פּאהלעך	פּייעלעך
פּאות	פּייעס
פּאותלעך	פּייעסלעך
פּאר	פּער
פּגום־כּלי	פּאָגעם־קיילע
פּגימה	פּגימע
פּגירה	פּגירע
פּגיריש	פּגיריש,פּעגיריש
פּגם	פּגאַם
פּגמים	פּגאָמים
פּגע	פּעגע
פּגע־רע	פּעגע־ראַ
פּגעים	פּגאָיִם
פּגעים־רעים	פּגאָיִם־ראָיִם
פּגר	פּייגער
פּגרט	פּייגערט
פּגרים	פּגאָרים
פּגרן	פּייגערן
פּגרנדיק	פּייגערנדיק
פּגרסט	פּייגערסט
פּדיון	פּידיען
פּדיון־הבן	פּידיען־האַבען
פּדיון־הנפֿש	פּידיען־האַנעפֿעש
פּדיון־שבֿויים	פּידיען־שוווּיִם
פּדיונות	פּידיוינעס
פּה־אחד	פּע־עכעד
פּה־אל־פּה	פּע־על־פּע
פּה־לין	פּוי־לין
פּה־ניטמן	פּוי־ניטמען
פּה־ניקבר	פּוי־ניקבער
פּוגם	פּויגעם
פּוגע	פּויגייע
פּוגע־בכּבֿוד	פּויגייע־בעקאָוועד
פּוסק	פּויסעק
פּוסק־אַחרון	פּויסעק־אַכרען
פּוסקים	פּאָסקים
פּוסקים־אַחרונים	פּאָסקים־אַכרוינים
פּוסקים־ראשונים	פּאָסקים־רישוינים
פּועל	פּויעל
פּועל־יוצא	פּויעל־יויצע
פּועל־צדק	פּויעל־צעדעק
פּועלט	פּויעלט
פּועלי־ציון	פּאַלעציִען,פּויאַלע־ציִען
פּועלים	פּויאַלים
פּועלן	פּוילן,פּויעלן
פּועלנדיק	פּויעלנדיק
פּועלסט	פּויעלסט
פּוק	פּוק
פּוקד־עקרות	פּויקעד־אַקאָרעס
פּוקר	פּויקער
פּוקרים	פּאָקרים
פּורה	פּורע
פּורים	פּורים
פּורים־קטן	פּורים־קאָטן
פּורים־שפּיל	פּורים־שפּיל
פּורים־שפּילער	פּורים־שפּילער
פּורעניות	פּוראָניעס
פּורץ־גדר	פּוירעץ־געדער
פּורצי־גדר	פּאָרצע־געדער
פּורש־בשמו	פּוירעש־בישמוי
פּורש־מן־הציבור	פּוירעש־מין־האַציבער
פּושט־יד	פּוישעט־יאַד
פּושטי־יד	פּאָשטע־יאַד
פּושע־באלוקי־ישׂראל	פּאָשע־בעלויקיי־ייִסראָעל
פּושע־ישׂראל	פּאָשע־ייִסראָעל
פּושעי־ישׂראל	פּאָשע־ייִסראָעל
פּותּיקא	פּויטיקע
פּותּיקי	פּויטיקע
פּותר	פּויסער
פּותר־חלום	פּויסער־כאָלעם
פּותרים	פּאָסרים
פּזר	פּאָזער
פּזרן	פּאַזרען
פּזרנות	פּאַזראָנעס
פּזרנטע	פּאַזרענטע
פּזרנטעס	פּאַזרענטעס
פּזרנים	פּאַזראָנים
פּזרניש	פּאַזראָניש
פּחד	פּאַכעד
פּחדים	פּכאָדים
פּחדימדיק	פּכאָדימדיק
פּחדן	פּאַכדן
פּחדנות	פּאַכדאָנעס
פּחדנטע	פּאַכדנטע
פּחדנטעס	פּאַכדנטעס
פּחדנים	פּאַכדאָנים
פּחדניש	פּאַכדאָניש
פּחות־משווה־פּרוטה	פּאָכעס־מישאָווע־פּרוטע
פּחיתות־הכּבֿוד	פּכיסעס־האַקאָוועד
פּטור	פּאָטער
פּטור בלא כּלום	פּאָטער בעלוי קלום
פּטירה	פּטירע
פּטירות	פּטירעס
פּטיש	פּאַטעש
פּטר	פּאַטער
פּטרט	פּאַטערט
פּטרן	פּאַטערן
פּטרנדיק	פּאַטערנדיק
פּטרניש	פּאַטערניש
פּטרסט	פּאַטערסט
פּטרסטו	פּאַטערסטו
פּי	פּי
פּיגול	פּיגל
פּיו־הקדוש	פּיוו־האַקאָדעש
פּיוט	פּײַעט,פּיִעט
פּיוטים	פּיִוטים
פּיזמון	פּיזמען
פּיזמונות	פּיזמוינעס
פּיזמונים	פּיזמוינים
פּיטום	פּיטעם
פּיטום־הקטורת	פּיטעם־האַקטוירעס
פּײַטן	פּײַטן
פּײַטנים	פּײַטאָנים
פּילאי־פּלאָים	פּילע־פּלאָיִם
פּילוסוף	פּילוסוף
פּילפּול	פּילפּל
פּילפּולען	פּילפּלען
פּינחס	פּינכעס
פּינחס בן־אלעזר בן־אַהרן הכּהן	פּינכעס בען־עלאָזער בען־אַרן האַקויען
פּינחסן	פּינכעסן
פּינחסעס	פּינכעסעס
פּינקס	פּינקעס
פּינקסים	פּינקאָסים,פּינקייסים
פּיקוח־נפֿש	פּיקועך־נעפֿעש
פּיקח	פּיקייעך,פּיקעך
פּיקחות	פּיקכעס
פּיקחטע	פּיקייעכטע,פּיקעכטע
פּיקחטעס	פּיקייעכטעס,פּיקעכטעס
פּיקחים	פּיקכים
פּיקחית	פּיקכעס
פּירוד־הלבֿבֿות	פּיירעד־האַלוואָוועס
פּירוש	פּיירעש
פּירוש־המילות	פּיירעש־האַמילעס
פּירושים	פּערושים
פּירות	פּיירעס
פּירסום	פּירסעם
פּירקי־אָבֿות	פּירקע־אָוועס
פּיתום־ורעמסס	פּיסעם־וועראַמסעס
פּיתחון־פּה	פּיסכן־פּע
פּיתרון	פּיסרען
פּיתרונים	פּיסרוינים
פּלא	פּיילע,פּעלע
פּלאָים	פּלאָיִם
פּלגש	פּילעגעש
פּלגשים	פּילאַקשים
פּלוגתּא	פּלוקטע
פּלוני	פּלוינע
פּלוני־אַלמוני	פּלוינע־אַלמוינע
פּלוני־בן־פּלוני	פּלוינע־בען־פּלוינע
פּלונית	פּלוינעס
פּלונית־בת־פּלונית	פּלוינעס־באַס־פּלוינעס
פּלוניתטע	פּלוינעסטע
פּלוניתטעס	פּלוינעסטעס
פּלטיאל	פּאַלטיִעל
פּליאה	פּליִע
פּליאהדיק	פּליִעדיק
פּליט	פּאָלעט
פּליטה	פּלייטע
פּליטות	פּלייטעס
פּליטים	פּלייטים
פּלישתּי	פּלישטי
פּלישתּים	פּלישטים
פּמליא	פּאַמאַליע
פּמליא־של־מעלה	פּאַמאַליע־שעל־מײַלע
פּמליה	פּאַמאַליע
פּנו דרך	פּאַנו דערעך
פּנו מקום	פּאַנו מאָקעם
פּנחס	פּינכעס
פּנחסן	פּינכעסן
פּנחסעס	פּינכעסעס
פּני	פּניי
פּני־העיר	פּניי־האָיִר
פּניה	פּניִע
פּנים	פּאָנעם
פּנים־אל־פּנים	פּאָנעם־על־פּאָנעם
פּנים־חדשות	פּאָנעם־כאַדאָשעס
פּנים־חלשות	פּאָנעם־כאַלאָשעס
פּנימיות	פּנימיעס
פּנימל	פּענעמל
פּנימער	פּענעמער
פּנינה	פּנינע
פּסול	פּאָסל,פּסול
פּסול־לעדות	פּאָסל־לעיידעס
פּסולת	פּסוילעס
פּסוק	פּאָסעק
פּסוקים	פּסוקים
פּסח	פּייסעך
פּסח־שני	פּייסעך־שיינע
פּסחדיק	פּייסעכדיק
פּסחדיקן	פּייסעכדיקן
פּסחדיקס	פּייסעכדיקס
פּסחדיקע	פּייסעכדיקע
פּסחדיקער	פּייסעכדיקער
פּסחים	פּסאָכים
פּסחיק	פּייסעכיק
פּסחיקן	פּייסעכיקן
פּסחיקס	פּייסעכיקס
פּסחיקע	פּייסעכיקע
פּסחיקער	פּייסעכיקער
פּסל	פּאַסל
פּסלות	פּאַסלעס
פּסלט	פּאַסלט
פּסלנות	פּאַסלאָנעס
פּסלסט	פּאַסלסט
פּסלען	פּאַסלען
פּסלענדיק	פּאַסלענדיק
פּסק	פּסאַק
פּסק־געלט	פּסאַק־געלט
פּסק־דין	פּסאַקדין
פּסקים	פּסאָקים
פּסקן	פּאַסקן
פּסקנט	פּאַסקנט
פּסקנסט	פּאַסקנסט
פּסקנסטו	פּאַסקנסטו
פּסקען	פּאַסקען
פּסקענען	פּאַסקענען
פּעולה	פּולע
פּעולות	פּולעס
פּעמים	פּעאָמים
פּקדון	פּיקאָדן
פּקדונות	פּיקדוינעס
פּקודי	פּקודע
פּרא	פּערע
פּרא־אָדם	פּערעאָדעם
פּראָים	פּראָיִם
פּרדס	פּאַרדעס
פּרדסים	פּאַרדייסים
פּרה	פּאָרע
פּרה־אַדומה	פּאָרע־אַדומע
פּרוזדור	פּרויזדער
פּרוטה	פּרוטע
פּרוטות	פּרוטעס
פּרוכת	פּאָרויכעס
פּרוכתן	פּאָרויכעסן
פּרוץ	פּאָרעץ
פּרוצה	פּרוצע
פּרוצים	פּרוצים
פּרוש	פּאָרעש
פּרושים	פּרושים
פּרות	פּיירעס
פּרות־הבשן	פּאָרעס־האַבאָשן
פּרחה־נשמתו	פּאָרכע־נישמאָסע
פּרט	פּראַט
פּרט־נאָמען	פּראַט־נאָמען
פּרט־נעמען	פּראַט־נעמען
פּרטים	פּראָטים
פּרי	פּיירע
פּרי־עץ־הדר	פּרי־אייץ־האָדער
פּריה־ורבֿיה	פּריִע־אורוויִע
פּריעה	פּריִע
פּריץ	פּאָרעץ
פּריצה	פּריצע
פּריצהדיק	פּריצעדיק
פּריצות	פּריצעס
פּריצטע	פּריצטע
פּריצטעס	פּריצטעס
פּריצים	פּריצים
פּריציש	פּריציש
פּרנס	פּאַרנעס
פּרנס־חודש	פּאַרנעס־כוידעש
פּרנס־חודשטע	פּאַרנעס־כוידעשטע
פּרנסה	פּאַרנאָסע
פּרנסה־בזויה	פּאַרנאָסע־בזוּיע
פּרנסה־בצימצום	פּאַרנאָסע־בעצימצעם
פּרנסה־בשפֿע	פּאַרנאָסע־בעשעפֿע
פּרנסות	פּאַרנאָסעס
פּרנסי־חודש	פּאַרנעסע־כוידעש
פּרנסים	פּאַרנאָסים,פּאַרנייסים
פּרס	פּאָרעס
פּרעה	פּאַרע
פּרעהס	פּאַרעס
פּרץ	פּערעץ
פּרצוף	פּאַרצעף
פּרצוף־פּנים	פּאַרצעף־פּאָנעם
פּרצופֿים	פּאַרצופֿים
פּרק	פּיירעק
פּרקדן	פּראַקדען
פּרקים	פּראָקים
פּרשה	פּאַרשע
פּרשות	פּאַרשעס
פּרת	פּראַס
פּשוט	פּאָשעט
פּשוט־כּמשמעו	פּאָשעט־קעמאַשמאָע
פּשוטו־כּמשמעו	פּשוטע־קעמאַשמאָע
פּשוטן	פּאָשעטן
פּשוטס	פּאָשעטס
פּשוטע	פּאָשעטע
פּשוטער	פּאָשעטער
פּשט	פּשאַט
פּשטות	פּאַשטעס
פּשטים	פּשאָטים
פּשטל	פּשעטל
פּשטלדיק	פּשעטלדיק
פּשטלען	פּשעטלען
פּשטן	פּאַשטן
פּשטנים	פּאַשטאָנים
פּשעים	פּשאָיִם
פּשרה	פּשאָרע
פּשרות	פּשאָרעס
פּשרן	פּאַשרען
פּשרנים	פּאַשראָנים
פּתּח	פּאַטעך
פּת בסלו	פּאַס בעסאַלע
פּת־עכּו״ם	פּאַס־אַקום
פּתאָים	פּסאָיִם
פּתח	פּאַסעך
פּתחיה	פּסאַכיע
פּתחיהן	פּסאַכיען
פּתחיהס	פּסאַכיעס
פּתי	פּעסי
פּתי־יאמין	פּעסי־יאַאַמען
פּתיחהן	פּסיכען
פּתיחהנען	פּסיכענען
פֿ	פֿיי
פֿא	פֿיי
פֿאַרדאגהט	פֿאַרדײַגעט
פֿאַרדבֿקעט	פֿאַרדווייקעט
פֿאַרחובֿען	פֿאַרכויווען
פֿאַרחושט	פֿאַרכושט
פֿאַרחושכט	פֿאַרכוישעכט
פֿאַרחתמעט	פֿאַרכאַסמעט
פֿאַרחתמעטן	פֿאַרכאַסמעטן
פֿאַרחתמעטע	פֿאַרכאַסמעטע
פֿאַרחתמעטער	פֿאַרכאַסמעטער
פֿאַרחתמען	פֿאַרכאַסמען
פֿאַרחתמענען	פֿאַרכאַסמענען
פֿאַריתומט	פֿאַריאָסעמט
פֿאַרכּוסעט	פֿאַרקויסעט
פֿאַרכּישופֿט	פֿאַרקישעפֿט
פֿאַרמוחן	פֿאַרמויעכן
פֿאַרמושבֿט	פֿאַרמוישעווט
פֿאַרמישפּט	פֿאַרמישפּעט
פֿאַרמישפּטן	פֿאַרמישפּעטן
פֿאַרמרה־שחורהט	פֿאַרמאָרעשכוירעט
פֿאַרמשכּונען	פֿאַרמאַשקענען
פֿאַרמשכּנען	פֿאַרמאַשקענען
פֿאַרסמט	פֿאַרסאַמט
פֿאַרסמטן	פֿאַרסאַמטן
פֿאַרסמטע	פֿאַרסאַמטע
פֿאַרסמטער	פֿאַרסאַמטער
פֿאַרסמען	פֿאַרסאַמען
פֿאַרעיפּושט	פֿאַריפּעשט
פֿאַרעקשנען	פֿאַראַקשענען
פֿאַרפּסח	פֿאַרפּייסעך
פֿאַרקנסט	פֿאַרקנאַסט
פֿאַרקנסן	פֿאַרקנאַסן
פֿאַרשיכּורט	פֿאַרשיקערט
פֿאַרשיכּורן	פֿאַרשיקערן
פֿאַרשמט	פֿאַרשעמט
פֿאַרשׂרפֿען	פֿאַרסאַרפֿען
פֿאַרתּכלעווען	פֿאַרטאַכלעווען
פֿצון	פֿאָצן
צ	צאַדעק
צאינה־וראינה	צענערענע
צאָן־קדשים	צאָן־קאָדאָשים
צאת־הכּוכבֿים	צייס־האַקויכאָווים
צאתך־לשלום	צייסכע־לעשאָלעם
צאתכם־לשלום	צייסכעם־לעשאָלעם
צבֿויאַטשען	צוווּיאַטשען
צבֿויאַטשקע	צוווּיאַטשקע
צבֿויאַטשקעס	צוווּיאַטשקעס
צבֿויאַק	צוווּיאַק
צבֿויאַקעס	צוווּיאַקעס
צבֿועטשען	צוווּאַטשען
צבֿועטשקע	צוווּאַטשקע
צבֿועטשקעס	צוווּאַטשקעס
צבֿועק	צוווּאַק
צבֿועקעס	צוווּאַקעס
צבֿי	צווי
צבֿיה	ציוויע
צבֿיס	צוויס
צבֿיעות	צוויִעס
צד	צאַד
צד־השווה	צאַד־האַשאָווע
צד־השונה	צאַד־האַשוינע
צד־שכּנגד	צאַד־שעקענעגעד
צד־שכּנגדו	צאַד־שעקענעגדע
צדדים	צדאָדים
צדה־לדרך	ציידע־לאַדערעך
צדוק	צאָדעק
צדוקים	צדוקים
צדוקן	צאָדעקן
צדוקס	צאָדעקס
צדי	צאַדי
צדיק	צאַדעק
צדיק־הדור	צאַדעק־האַדאָר
צדיק־תּמים	צאַדעק־טאָמעם
צדיקי־הדור	צאַדיקע־האַדאָר
צדיקים	צאַדיקים
צדיקים־תּמימים	צאַדיקים־טמימים
צדק	צעדעק
צדקה	צדאָקע
צדקה ממני	צאָדקאָ מימעני
צדקה תּציל ממוות	צדאָקע טאַצל מימאָוועס
צדקה־גדולה	צדאָקע־גדוילע
צדקה־פּושקע	צדאָקע־פּושקע
צדקות	צדאָקעס
צדקניות	ציטקאָניעס
צדקנית	ציטקאָנעס
צדקת	צעדייקעס
צדקתטע	צעדייקעסטע
צהלה	צאָהאָלע
צהלה־ושׂמחה	צאָהאַלע־וועסאָמייכע
צו	צאַוו
צו להכעיס	צעלאָכעס
צואה	צאַוואָע,צויע
צוהר	צויער
צוואה	צאַוואָע
צוואָות	צאַוואָעס
צולהכעיס	צעלאָכעס
צולהכעיסדיק	צעלאָכעסדיק
צולהכעיסניצע	צעלאָכעסניצע
צולהכעיסניק	צעלאָכעסניק
צום	צאָם
צום־גדליה	צאָמגעדאַליע
צומח	צוימייעך
צופּסקען	צופּאַסקען
צופּסקענען	צופּאַסקענען
צורבֿא־דרבנן	צורווע־דעראַבאָנען
צורה	צורע
צורות	צורעס
צורך	צוירעך
צורר	צוירער
צורר־היהודים	צוירער־האַיעהודים
צורר־ישׂראל	צוירער־ייִסראָעל
צוררים	צאָרערים
צורת־אות	צורעס־אָס
צורת־אַלף	צורעס־אַלעף
צורת־מטבע	צורעס־מאַטבייע
ציבור	ציבער
ציבורים	ציבורים
צידוק־הדין	צידעק־האַדין
צידקות	ציטקעס
ציון	ציִען
ציונות	ציִוינעס
ציוני	ציִויני
ציוניזם	ציִעניזם
ציונים	ציִונים
ציוניסט	ציִעניסט
ציוניסטיש	ציִעניסטיש
ציוניסטישן	ציִעניסטישן
ציוניסטישע	ציִעניסטישע
ציוניסטישער	ציִעניסטישער
ציוניסטן	ציִעניסטן
ציוניסטס	ציִעניסטס
צימוקים	צימוקים
צימצום	צימצעם
צינור	צינער
צינורות	צינוירעס
ציצה	ציצע
ציצה־כּנפֿות	ציצע־קאַנפֿעס
ציצה־כּנפֿותלעך	ציצע־קאַנפֿעסלעך
ציצות	ציצעס
ציצית	ציצעס
צירוף	ציירעף
צירופֿי־אותיות	ציירופֿע־אויסיעס
צירופֿים	ציירופֿים
צירי	ציירע
צלאל	צאַלעל
צלאלן	צאַלעלן
צלאלס	צאַלעלס
צלל	צאַלעל
צללן	צאַלעלן
צללס	צאַלעלס
צלם	ציילעם
צלם־אלוהים	ציילעם־עלויהים
צלם־אלוקים	ציילעם־עלויקים
צלם־קאָפּ	ציילעם־קאָפּ
צלמוות	צאַלמאָוועס
צלמים	צלאָמים
צלמניצע	ציילעמניצע
צלמניק	ציילעמניק
צלמען	ציילעמען
צמח	צעמעך
צמחים	צמאָכים
צנא־דמלא־סיפֿרא	צאַנע־דימלע־סיפֿרע
צנועה	צנוע
צנועהדיק	צנועדיק
צנועהדיקן	צנועדיקן
צנועהדיקס	צנועדיקס
צנועהדיקע	צנועדיקע
צנועהדיקער	צנועדיקער
צנועהלע	צנועלע
צנועות	צנועס
צניעות	צניִעס
צניעותדיק	צניִעסדיק
צניעותדיקן	צניִעסדיקן
צניעותדיקס	צניִעסדיקס
צניעותדיקע	צניִעסדיקע
צניעותדיקער	צניִעסדיקער
צעדמען	צעדאַמען
צעחושט	צעכושט
צעמזיקן	צעמאַזעקן
צער	צאַר
צער־בעלי־חיים	צאַר־באַלעכאַיִם
צער־גידול־בנים	צאַר־גידל־באָנים
צפּורה	ציפּוירע
צפֿון	צאָפֿן
צפֿניה	צפֿאַניע
צפֿרדע	צפֿאַרדייע
צפֿת	צפֿאַס
צץ	צאָץ
צר־עין	צאַר־אַיִן
צרה	צאָרע
צרה־שלא־תבֿוא	צאָרע־שעלוי־סאָוווי
צרהדיק	צאָרעדיק
צרות	צאָרעס
צרות־הכּלל	צאָרעס־האַקלאַל
צרות־ישׂראל	צאָרעס־ייִסראָעל
צרות־צרורות	צאָרעס־צרורעס
צרכי־ציבור	צאָרכע־ציבער
צרכי־רבים	צאָרכע־ראַבים
צרכים	צראָכים
צרעת	צאָראַאַס
צרת־רבים	צאָרעס־ראַבים
צרת־רבים חצי־נחמה	צאָרעס־ראַבים כאָצי־נעכאָמע
ק	קוף
קבלה	קאַבאָלע
קבלה־מעשׂית	קאַבאָלע־מײַסיס
קבלה־עיונית	קאַבאָלע־איִוניס
קבלו דעתּי	קאַבלו דאַטי
קבלות	קאַבאָלעס
קבלת־פּנים	קאַבאָלעס־פּאָנעם
קבלת־קנין	קאַבאָלעס־קיניען
קבלת־שבת	קאַבאָלעס־שאַבעס
קבצן	קאַבצן,קאַפּצן
קבצנות	קאַבצאָנעס,קאַפּצאָנעס
קבצנטע	קאַבצנטע,קאַפּצנטע
קבצנטעס	קאַבצנטעס
קבצנים	קאַבצאָנים,קאַפּצאָנים
קבצניש	קאַבצאָניש
קבצנישן	קאַבצאָנישן
קבצנישע	קאַבצאָנישע
קבצנישער	קאַבצאָנישער
קבצנען	קאַבצענען,קאַפּצענען
קברן	קאַברען
קברנים	קאַבראָנים
קברנס	קאַברענס
קבֿ־הישר	קאַוו־האַיאָשער
קבֿורה	קוווּרע
קבֿורת־חמור	קוווּרעס־כאַמער
קבֿורת־ישׂראל	קוווּרעס־ייִסראָעל
קבֿיעות	קוויִעס
קבֿר	קייווער
קבֿר־אָבֿות	קייווער־אָוועס
קבֿר־ישׂראל	קייווער־ייִסראָעל
קבֿרות	קוואָרעס
קבֿרות־בלעטער	קוואָרעס־בלעטער
קבֿרות־ייִד	קוואָרעס־ייִד
קבֿרות־מאַן	קוואָרעס־מאַן
קבֿרות־שטיבל	קוואָרעס־שטיבל
קבֿרותניק	קוואָרעסניק
קבֿרים	קוואָרים
קדוש	קאָדעש,קידעש
קדוש־וטהור	קאָדעש־וועטאָהער
קדושה	קדושע
קדושים	קדוישים
קדושים־וטהורים	קדוישים־אוטעהוירים
קדחת	קאַדאָכעס
קדחת־רבֿיעית	קאַדאָכעס־רעוויִעס
קדחת־שלישית	קאַדאָכעס־שלישעס
קדיש	קאַדעש
קדישים	קאַדיישים
קדישניק	קאַדעשניק
קדמא־ואזלא	קאַדמע־וועאַזלע
קדמון	קאַדמען
קדמונים	קאַדמוינים
קדר	קיידער
קדרים	קדאָרים
קדשי־קדשים	קאָדשע־קאָדאָשים
קדשים	קאָדאָשים,קאָדשים
קדשים־קלים	קאָדאָשים־קאַלים,קאָדשים־קאַלים
קהילה	קעהילע
קהילה־קדושה	קעהילע־קדוישע
קהילות	קעהילעס
קהל	קאָאָל
קהל־חסידים	קעהאַל־כאַסידים,קעהאַל־כסידים
קהליש	קאָאָליש
קהלן	קאָאָלן
קהלס־מאַן	קאָאָלס־מאַן
קהלש	קאָאָלש
קהלת	קויהעלעס
קובוץ	קובוץ
קובֿע	קויווייע
קובֿר	קויווער
קודם	קוידעם
קודם־כּל	קוידעמקאָל
קודם־לכּל	קוידעם־לאַקל
קודש	קוידעש
קודש־קדשים	קוידעש־קאָדאָשים
קודשא־בריך־הוא	קודשע־בעריך־הו
קול	קאָל
קול־התּורה	קאָל־האַטוירע
קול־מבֿשׂר	קאָל־מעוואַסער
קול־נגינה	קאָל־נעגינע
קול־קורא	קאָלקוירע
קולא	קולע
קולות	קוילעס
קולות־ובֿרקים	קוילעס־אוּווראָקים
קולי־קולות	קוילע־קוילעס
קולכל	קעלכל
קולעכל	קעלעכל
קולער	קעלער
קוממיות	קוימעמיִעס
קונדס	קונדעס
קונדסים	קונדייסים
קונדסערײַ	קונדעסערײַ
קונה	קוינע
קונה־הכּל	קוינע־האַקל
קונה־זכות	קוינע־סכוס
קונה־עולם	קוינע־אוילעם
קונה־שם	קוינע־שעם
קונהטע	קוינעטע
קונהטעס	קוינעטעס
קונטרס	קונטרעס
קונטרסים	קונטרייסים
קונים	קוינים
קופּה־של־שרצים	קופּע־שעל־שראָצים
קוף	קוף
קופֿץ־בראָש	קויפֿעץ־בעראָש
קוצו־של־יוד	קויצע־שעליוד,קוצע־שעליוד
קורא־ניכבד	קוירע־ניכבעד
קוראים־נכבדים	קוירים־ניכבאָדים
קורח	קוירעך
קורע	קוירייע
קורע־כּדג	קוירייע־קעדאַג
קטורת	קטוירעס
קטיגור	קאַטייגער
קטיגורס	קאַטייגערס
קטלא־קניא	קאַטלע־קאַניע
קטלן	קאַטלען
קטלניות	קאַטלאַניעס
קטלנים	קאַטלאָנים
קטלנית	קאַטלאַנעס
קטן	קאָטן
קטנות־דמוחין	קאַטנעס־דעמויכן
קטני־אמונה	קטאַניי־עמונע
קטני־אמנה	קטאַניי־עמאָנע
קטנים	קטאַנים
קטנתּי	קאָטוינטי
קיאה	קייע
קיבוץ	קיבוץ,קיבעץ
קיבוץ־גלויות	קיבעץ־גאָליעס
קיבוצים	קיבוצים
קידוש	קידעש
קידוש־החודש	קידעש־האַכוידעש
קידוש־השם	קידעש־האַשעם
קידוש־לבֿנה	קידעש־לעוואָנע
קידוש־לבֿנה־אותיות	קידעש־לעוואָנע־אויסיעס
קידושין	קידושין,קידושן
קיום	קיִעם
קיום־האומה	קיִעם־האָומע
קיטניות	קיטניעס
קיטרוג	קיטרעג
קײַמא־לן	קײַמעלאָן
קין	קאַיִן
קינאה	קינע
קינאה־שׂינאה	קינע־סינע
קינאת־סופֿרים	קינעס־סאָפֿרים
קינה	קינע
קינות	קינעס
קינים	קינים
קיסר	קייסער
קיסר ירום הודו	קייסער יאָרעם הוידע
קיסרים	קייסאָרים,קיסריִיִם
קיסריניע	קייסעריניע
קיסרינע	קייסערינע
קיצבֿה	קיצווע
קיצור	קיצער
קיצור־הדבֿר	קיצער־האַדאָווער
קיצור־המעשׂה	קיצער־האַמײַסע
קיצור־ימים	קיצער־יאָמים
קיצורים	קיצורים
קיר״ה	קירע
קיר״ה־דײַטש	קירע־דײַטש
קל	קאַל
קל־וחומר	קאַלוועכוימער
קל־שבקלים	קאַל־שעבעקאַלים
קלאָץ־קשיא	קלאָץ־קאַשע
קלונימוס	קלוינעמעס
קלות	קאַלעס
קלות־דעת	קאַלעס־דאַאַס
קלות־ראָש	קאַלעס־ראָש
קליין־ש״ס	קליינשאַס
קליפּה	קליפּע
קליפּות	קליפּעס
קללה	קלאָלע
קללהן	קלאָלען
קללות	קלאָלעס
קללות־וחרמות	קלאָלעס־אוכראָמעס
קללות־חרמות	קלאָלעס־כראָמעס
קללות־נימרצות	קלאָלעס־נימראָצעס
קלמן	קאַלמען
קלסתּר־פּנים	קלאַסטער־פּאָנעם
קלפּי	קאַלפּע
קלפֿי	קאַלפֿע
קמח־פּסח	קעמעך־פּייסעך
קמחא־דפּסחא	קימכע־דעפּאַסכע
קמיע	קאַמייע
קמיעות	קאַמייעס
קמץ	קאָמעץ
קמצן	קאַמצן
קמצנות	קאַמצאָנעס
קמצנטע	קאַמצנטע
קמצנטעס	קאַמצנטעס
קמצנים	קאַמצאָנים
קמצנס	קאַמצנס
ק״ן	קאַן
קן־ציפּור	קענציפּער
קנאָות	קאַנאָעס
קנאָי	קאַנאָיִ
קנאָים	קאַנאָיִם
קנאָיש	קאַנאָיִש
קנאָישן	קאַנאָיִשן
קנאָישע	קאַנאָיִשע
קנאָישער	קאַנאָיִשער
קנה	קאָנע
קנוניא	קנוניע
קניה	קניִע
קנין	קיניען
קנין־הקהל	קיניען־האַקאָאָל
קנינים	קיניאָנים
קנס	קנאַס
קנס־מאָל	קנאַס־מאָל
קנסים	קנאָסים
קנסען	קאַנסען
קנסענען	קאַנסענען
קערה	קאַאַרע,קײַרע
קערות	קאַאַרעס,קײַרעס
קפּדן	קאַפּדן
קפּדנים	קאַפּדאָנים
קפּידא	קפּיידע
קפּידה	קפּיידע
קפֿיצת־הדרך	קפֿיצעס־האַדערעך
קפֿריסין	קאַפֿריסן
קפֿריסינדיק	קאַפֿריסנדיק
קץ	קעץ
קץ־הימין	קעץ־האַיאָמען
קצבֿ	קאַצעוו
קצבֿות	קאַצאָוועס
קצבֿטע	קאַצעווטע
קצבֿים	קאַצאָווים
קצבֿיש	קאַצאָוויש
קצבֿישן	קאַצאָווישן
קצבֿישע	קאַצאָווישע
קצבֿישער	קאַצאָווישער
קצין	קאָצן
קצינים	קצינים
ק״ק	קאַק
קקיון־דיונה	קיקויען־דעיוינע
ק״קעלע־קהל	קעקעלע־קאָאָל
קראָי	קראָיִ
קרבן	קאָרבן
קרבן־מינחה	קאָרבן־מינכע
קרבן־מינחה־סידור	קאָרבן־מינכע־סידער
קרבנות	קאָרבאָנעס
קרבֿות	קרייוועס
קרובֿ	קאָרעוו
קרובֿ־לאמת	קאָרעוו־לעעמעס
קרובֿ־למלכות	קאָרעוו־לעמאַלכעס
קרובֿ־למקח	קאָרעוו־לעמייקעך
קרובֿה	קרויווע
קרובֿהטע	קרויוועטע
קרובֿהטעס	קרויוועטעס
קרובֿטע	קאָרעווטע
קרובֿים	קרויווים
קרובֿים־למלכות	קרויווים־לעמאַלכעס
קרובֿישאַפֿט	קרויווישאַפֿט
קרוע־בלוע	קרוע־בלוע
קרועה־ובֿלויה	קרוע־אוּוולוע
קרח	קוירעך
קרי	קיירע,קערי,קרי
קריאת־התּורה	קריִעס־האַטוירע
קריאת־שמע	קרישמע
קריעה	קריִע
קריעת־ים־סוף	קריִעס־יאַמסוף
קרירה	קרירע
קרן	קערן
קרן־קימת	קערן־קאַיעמעס
קרקע	קאַרקע
קרקע־בתולה	קאַרקע־פּסולע
קרקעות	קאַרקאָעס
קרשים	קראָשים
קשה	קאָשע
קשה־עורף	קשיי־אוירעף
קשי־עורף	קשי־אוירעף
קשיא	קאַשע
קשיות	קאַשעס
קשר	קעשער
קשת	קאַשעס
ר	רייש
ר׳	רעב
ראה	רעיי
ראובֿן	רוּוון
ראובֿנס	רוּוונס
ראָוי	ראָע
ראָוי־להוראה	ראָע־לעהויראָע
ראָוי־לחופּה	ראָע־לעכופּע
ראַיה	רײַע
ראיה	ריִע
ראַיה־לדבֿר	רײַע־לעדאָווער
ראַיות	רײַעס
ראַיות־ברורות	רײַעס־ברורעס
רא״ש	ראָש
ראָש	ראָש
ראָש־בית־דין	ראָש־בעזדן,ראָש־בעזן,ראָשע־בעזדן,ראָשע־בעזן
ראָש־הגולה	ראָש־האַגוילע
ראָש־הדיינים	ראָש־האַדאַיאָנים
ראָש־המדברים	ראָש־האַמעדאַברים
ראָש־הקהל	ראָשאַקאָאָל
ראָש־השנה	ראָשעשאָנע
ראָש־וראשון	ראָש־ווערישן
ראָש־חודש	רעשכוידעש
ראָש־חודש־געלט	רעשכוידעש־געלט
ראָש־חודש־רעטעכל	רעשכוידעש־רעטעכל
ראָש־ישיבֿה	ראָשיעשיווע
ראש־עירון	רעשיירן
ראשו־ורובו	רוישע־ווערובע
ראשון	רישן
ראשונים	רישוינים
ראָשי־הגולה	ראָשע־האַגוילע
ראָשי־המדברים	ראָשע־האַמעדאַברים
ראָשי־הקהל	ראָשעקאָאָל
ראשי־ורובי	רוישי־ווערובי
ראָשי־ישיבֿות	ראָשע־יעשיוועס
ראָשי־פּרקים	ראָשעפּראָקים
ראָשי־תּיבֿות	ראָשעטייוועס
ראשית	ריישעס
ראשית־דבֿר	ריישעס־דאָווער
ראשית־חכמה	ריישעס־כאָכמע
רב	רעב
רבא בר־בר־חנה	ראַבע באַר־באַר־כאָנע
רבה בר־בר־חנה	ראַבע באַר־באַר־כאָנע
רבונא־דעלמא	ריבוינע־דעאַלמע
רבונא־דעלמא־כּולא	ריבוינע־דעאַלמע־קולע
רבונו־של־עולם	רעבוינע־שעלוילעם
רבותי	ראַבויסײַ
רבותים	ראַבויסים
רבי	רעבע
רבי־געלט	רעבע־געלט
רביים	ראַבעיִם
רבייִש	ראַבעיִש
רבים	ראַבים
רבין	רעבם
רביניו	רעבעניו
רבינס	רעבמס
רביס	רעבעס
רביסטווע	רעביסטווע
רביצין	רעבעצן
רביצינס	רעבעצנס
רביש	רעבעש
רבישאַפֿט	רעבעשאַפֿט
רבנו	ראַביינו
רבנו תּם	ראַביינו טאַם
רבנו תּמס תּפֿילין	ראַביינו טאַמס טפֿילן
רבנות	ראַבאָנעס
רבנים	ראַבאָנים
רבניש	ראַבאָניש
רבנן־קדיש	ראַבאָנען־קאַדעש
רבֿ	ראָוו,ראַוו
רבֿ־הכּולל	ראַוו־האַקוילעל
רבֿ־הראָשי	ראַוו־האָראָשי
רבֿותא	רעוווּסע
רבֿיעי	רעוויִיִ
רבֿל	רעוול
רבֿס	ראָווס
רבֿקה	ריווקע,ריפֿקע
רבֿקהלע	ריווקעלע
רבֿקהלען	ריווקעלען
רבֿקהלעס	ריווקעלעס
רבֿקהן	ריווקען
רבֿקהס	ריווקעס
רגזן	ראַגזן
רגזנות	ראַגזאָנעס
רגזנטע	ראַגזנטע
רגזנטעס	ראַגזנטעס
רגזנים	ראַגזאָנים
רגיל	ראָגל
רגילות	רעגילעס
רגילים	רעגילים
רגל	רעגל
רגלים	ראַגלאַיִם,רעגאָלים
רגע	רעגע
רגע־כּמימרא	רעגע־קעמעמרע
רדיפֿה	רעדיפֿע
רדיפֿות	רעדיפֿעס
רואה־ואינו־ניראה	רויע־וועיינע־נירע
רואה־חשבון	רויע־כעזשבם
רובל־כּסף	רובל־קעסעף
רובֿ	ראָוו
רובֿ־בנין־ורובֿ־קנין	ראָווביניען־וועראָווקיניען
רובֿ־גדלו־ורובֿ־עשרו	ראָווגאָדלע־וועראָוואָשרע
רובֿ־דעות	ראָוו־דייעס
רובֿ־כּוס	ראָוו־קאָס
רובֿ־מנין־ורובֿ־בנין	ראָוומיניען־וועראָווביניען
רוגז	רויגעז
רוגזא	רוגזע
רוגזה	רוגזע
רודף־כּבֿוד	רוידעף־קאָוועד
רודף־שלום	רוידעף־שאָלעם
רודף־שלומניק	רוידעף־שאָלעמניק
רודפֿי־כּבֿוד	ראָדפֿע־קאָוועד,ראָטפֿע־קאָוועד
רודפֿי־שלום	ראָדפֿע־שאָלעם,ראָטפֿע־שאָלעם
רודפֿן	רוידעפֿן
רווח	רעוועך
רווחים	רעוואָכים
רוח	רועך
רוח־החיים	רועך־האַכאַיִם
רוח־הקודש	רועך־האַקוידעש
רוח־חיים	רועך־כאַיִם
רוח־רע	רועך־ראַ
רוח־רעה	רועך־ראָע
רוח־שטות	רועך־שטוס
רוחות	רוכעס
רוחות־רעות	רוכעס־ראָעס
רוחות־רעים	רוכעס־ראָיִם
רוחניות	רוכניִעס
רופֿא	רויפֿע
רופֿא־חולים	רויפֿע־כוילים
רופֿאטע	רויפֿעטע
רופֿאטעס	רויפֿעטעס
רופֿאים	רויפֿים
רופֿאס	רויפֿעס
רוצח	רעצייעך
רוצחטע	רעצייעכטע
רוצחים	ראָצכים
רוקח	רעקייעך
רושם	רוישעם
רות	רוס
רזיאל	ראַזיעל
רזין־דרזין	ראָזן־דעראָזן
רחבֿ	ראָכעוו
רחבֿ הזונה	ראָכעוו האַזוינע
רחבֿות	ראַכוועס
רחבֿותדיק	ראַכוועסדיק
רחבֿותדיקייט	ראַכוועסדיקייט
רחבֿותדיקן	ראַכוועסדיקן
רחבֿותדיקס	ראַכוועסדיקס
רחבֿותדיקע	ראַכוועסדיקע
רחבֿותדיקער	ראַכוועסדיקער
רחום	ראַכעם
רחום־וחנון	ראַכעם־וועכאַנען
רחוק	ראָכעק
רחל	ראָכל
רחלן	ראָכלען
רחלס	ראָכלס
רחלע	ראָכעלע
רחלען	ראָכעלען
רחלעס	ראָכעלעס
רחמיאל	ראַכמיל,ראַכמיִעל
רחמיאלן	ראַכמיִעלן
רחמיאלס	ראַכמיִעלס
רחמים	ראַכמים
רחמן	ראַכמען
רחמנא־יצילינו	ראַכמאָנע־יעציליינע
רחמנא־לצלן	ראַכמאָנע־ליצלאַן
רחמנות	ראַכמאָנעס
רחמנות־פּנים	ראַכמאָנעס־פּאָנעם
רחמנות־פּנימער	ראַכמאָנעס־פּענעמער
רחמנים	ראַכמאָנים
רח״ש	ראַכאַש,רעכאַש
ריאה	רייע
ריבית	ריבעס
ריביתניק	ריבעסניק
ריח	רייעך
ריח־ניחוח	רייעך־ניכויעך
ריח־תּורה	רייעך־טוירע
ריחות	רייכעס
ריסוק־אבֿרים	ריסעק־אייוורים
ריק	רייק
ריקוד	ריקעד
ריקודים	ריקודים
ריש	רייש
ריש־גלותא	רייש־גאָלוסע
רישעות	רישעס
רך־הנולד	ראַך־האַנוילעד
רך־הנימול	ראַך־האַנימל
רך־לבֿ	ראַך־לעוו
רכילות	רעכילעס
רכילותן	רעכילעסן
רכילותניצע	רעכילעסניצע
רכילותניק	רעכילעסניק
רמ״א	רעמאָ
רמאָות	ראַמאָעס
רמאַי	ראַמײַ
רמאָים	ראַמאָיִם
רמבם	ראַמבאַם
רמב״ם	ראַמבאַם
רמז	רעמעז
רמזים	רעמאָזים
רמ״ח	ראַמאַך,רעמאַך
רמ״ח אבֿרים	ראַמאַך אייוורים,רעמאַך אייוורים
רעה	ראָע
רעיון	רײַען
רעיונות	ראַיוינעס
רעיתו	ראַיאָסע
רעיתי	ראַיאָסי
רעש	ראַש
רעשן	ראַשן
רפֿאל	רעפֿאָעל
רפֿה	ראָפֿע
רפֿואה	רעפֿוע
רפֿואה־בדוקה	רעפֿוע־בדוקע
רפֿואה־שלמה	רעפֿוע־שליימע
רפֿואות	רעפֿועס
רצון	ראָצן
רצועה	רעצוע
רצועות	רעצועס
רצחן	ראַצכן
רצחנים	ראַצכאָנים
רצחען	ראַצכען
רצחענען	ראַצכענען
רציחה	רעציכע
רציחהדיק	רעציכעדיק
רציחהדיקן	רעציכעדיקן
רציחהדיקע	רעציכעדיקע
רציחהדיקער	רעציכעדיקער
רק	ראַק
רקידה	רעקידע
רשות	רעשוס
רשות־היחיד	רעשוס־האַיאָכעד
רשות־הרבים	רעשוס־האָראַבים
רשי	ראַשע
רש״י	ראַשע
רשי־כּתבֿ	ראַשע־קסאַוו
רשימה	רעשימע
רשימות	רעשימעס
רשיס	ראַשעס
רש״יס	ראַשעס
רשע	ראָשע
רשע־גמור	ראָשע־גאָמער
רשע־מרושע	ראָשע־מערושע
רשעטע	ראָשייטע,ראָשעטע
רשעים	רעשאָיִם
רשעים־גמורים	רעשאָיִם־גמורים
רשענטע	רעשאַנטע
ש	שין
ש…	שע…
שאגת־אַריה	שײַגעס־אַריע
שאָול	שאָעל
שאול־תּחתּיה	שאָל־טאַכטיִע
שאול־תּחתּית	שאָל־טאַכטיס
שאין כּוחם אלא בפֿיהם	שעיין קויכעם עלאָ בעפֿיהעם
שאין מכּירין	שעיין מאַקירן
שאינו־יודע־לשאול	שעיינע־יעדייע־לישויל
שאלה	שײַלע
שאלות	שײַלעס
שאלות־ותּשובֿות	שײַלעס־אוטשוּוועס
שאלות־תּשובֿות	שײַלעס־טשוּוועס
שאלת־הריאה	שײַלעס־האָרייע
שאלת־נשים	שײַלעס־נאָשים
שאלת־תּשובֿה	שײַלעס־טשוּווע
שאָני	שאָנע
שאָני הכא	שאָנע האָכע
שאָר־אַרצות	שאָר־אַראָצעס
שאר־בשׂר	שיירבאָסער
שאָר־ירקות	שאָריעראָקעס
שארית	שיירעס
שארית־הפּליטה	שיירעס־האַפּלייטע
שב…	שעבאַ…,שעבע…
שבכּתבֿ	שעביקסאַוו
שבעולם	שעבאָוילעם
שבעל־פּה	שעבאַלפּע
שבת	שאַבעס
שבת־בראשית	שאַבעס־בריישעס
שבת־גוי	שאַבעסגוי
שבת־גויים	שאַבעס־גאָיִם
שבת־גויע	שאַבעס־גויע
שבת־גויעס	שאַבעס־גויעס
שבת־הגדול	שאַבעס־האַגאָדל
שבת־חזון	שאַבעס־כאַזאָן
שבת־ליכט	שאַבעס־ליכט
שבת־מבֿרכים	שאַבעס־מעוואָרכים
שבת־נחמו	שאַבעס־נאַכמו
שבת־צו־נאַכט	שבייסענאַכט
שבת־צו־נאַכטס	שבייסענאַכטס
שבת־קודש	שאַבעס־קוידעש
שבת־שבתון	שאַבעס־שאַבאָסן
שבת־שובֿה	שאַבעס־שוּווע
שבת־שטעך	שאַבעס־שטעך
שבת־שטעפּ	שאַבעס־שטעפּ
שבת־שירה	שאַבעס־שירע
שבת־תּשובֿה	שאַבעס־טשוּווע
שבתדיק	שאַבעסדיק
שבתדיקן	שאַבעסדיקן
שבתדיקס	שאַבעסדיקס
שבתדיקע	שאַבעסדיקע
שבתדיקער	שאַבעסדיקער
שבתי	שאַפּסע
שבתי־צבֿי	שאַפּסע־צווי
שבתי־צבֿיניק	שאַפּסע־צוויניק
שבתים	שאַבאָסים
שבתין	שאַפּסען
שבתיס	שאַפּסעס
שבתע־נאַכט	שאַבייסענאַכט
שבתע־נאַכטס	שאַבייסענאַכטס
שבֿועה	שוווּע
שבֿועות	שוווּעס
שבֿועתל	שוווּעסל
שבֿח	שוואַך,שעוואַך,שעוועך
שבֿחי־בעל־שם־טובֿ	שיפֿכע־באַלשעמטאָוו
שבֿחי־הבעש״ט	שיפֿכע־האַבעשט
שבֿחים	שוואָכים
שבֿט	שוואַט,שייוועט
שבֿטים	שוואָטים
שבֿיעי	שוויִיִ
שבֿיעי־של־פּסח	שוויִיִ־שעל־פּייסעך
שבֿיעית	שוויִיִס
שבֿע	שעווע
שבֿע־ברכות	שעווע־בראָכעס,שעווע־בראָכעס
שבֿע־חכמות	שעווע־כאָכמעס
שבֿען	שעווען
שבֿעס	שעוועס
שבֿר	שעווער
שבֿרים	שוואָרים
שבֿרירי ברירי רירי רי	שאַוורירע ברירע רירע רי
שבֿת־אַחים	שעוועס־אַכים
שגעון	שיגאָען
שגעונות	שיגוינעס
שגעונען	שיגאָנען
שד	שעד
שדי	שאַדײַ
שדי קרע שׂטן	שאַדײַ קראַ סאָטן
שדיכע	שעדעכע
שדים	שיידים
שדכן	שאַטכן
שדכנות	שאַטכאָנעס
שדכנטע	שאַטכנטע
שדכנטעס	שאַטכנטעס
שדכנים	שאַטכאָנים
שדכנען	שאַטכענען
שד״ר	שאַדאַר
שהחיינו	שעכעיאָנו
שהי־פּהי	שיִע־פּיִע
שהיות	שיִעס
שהכּל	שעהאַקל
שואל	שויעל
שואל־עצה	שויעל־אייצע
שואלן	שויעלן
שואלס	שויעלס
שוגג	שויגעג
שוואָ	שוואָ
שווא	שייווע
שווא־ושקר	שאַוועשעקער
שוואַרץ־מאהדיק	שוואַרצמייעדיק
שוואַרץ־מאהניק	שוואַרצמייעניק
שווה־בשווה	שאָווע־בעשאָווע
שווה־כּסף	שאָווע־קעסעף
שווה־לכּל־נפֿש	שאָווע־לעקאָלנעפֿעש
שוחד	שויכעד
שוחט	שויכעט
שוחטות	שאָכטעס
שוחטים	שאָכטים
שוחטס	שויכעטס
שוחטקע	שויכעטקע
שוחטקעס	שויכעטקעס
שוטה	שויטע
שוטים	שויטים
שויתי	שיוויסי
שויתי ה׳ לנגדי תּמיד	שיוויסי אַדוישעם לענעגדי טאָמעד
שוכן־עפֿר	שאָכניי־אָפֿער,שויכן־אָפֿער
שולחן	שולכן
שולחן־ערוך	שולכן־אָרעך
שולט	שוילעט
שולמית	שולאַמיס
שום	שום
שומו שמים	שוימו שאָמאַיִם
שומר	שוימער
שומר־ומציל	שוימער־אומאַצל
שומר־חינם	שוימער־כינעם
שומר־ישׂראל	שוימער־ייִסראָעל
שומר־פּתאָים	שוימער־פּסאָיִם
שומר־שבת	שוימער־שאַבעס
שומר־שׂכר	שוימער־סאָכער
שומרי־שבת	שאָמרע־שאַבעס
שומרים	שאָמרים
שופֿט	שויפֿעט
שופֿטים	שאָפֿטים
שופֿך־דם	שויפֿעך־דאַם
שופֿך־דמים	שויפֿעך־דאָמים
שופֿר	שויפֿער
שופֿר־של־משיח	שויפֿער־שעל־מעשיִעך
שופֿרא־דשופֿרא	שופֿרע־דעשופֿרע
שופֿרות	שויפֿרעס
שור	שאָר
שור־הבר	שאָראַבאָר
שור־הניסקל	שאָר־האַניסקל
שורה	שורע
שורה־גריזל	שורע־גריזל
שורות	שורעס
שורק	שורעק
שורש	שוירעש
שורשים	שעראָשים
שושן־הבירה	שושן־האַבירע
שושן־פּורים	שושן־פּורים
שושנת־יעקבֿ	שוישאַנעס־יאַנקעוו
שותּף	שוטעף
שותּפֿות	שוטפֿעס
שותּפֿותדיק	שוטפֿעסדיק
שותּפֿטע	שוטעפֿטע
שותּפֿטעס	שוטעפֿטעס
שותּפֿים	שוטפֿים
שותּפֿיש	שוטפֿיש
שותק	שויסעק
שותקים	שאָסקים
שחטן	שעכטן
שחיטה	שכיטע
שחיטות	שכיטעס
שחיטת־חולין	שכיטעס־כולין
שחיטת־חוץ	שכיטעס־כוץ
שחין	שכין
שחרית	שאַכרעס
שחריתים	שאַכרייסים
שטות	שטוס
שטותים	שטוסים
שטותערײַ	שטוסערײַ
שטח	שעטעך
שטחים	שטאָכים
שטיא	שאַטיע
שטר	שטאַר
שטר־חובֿ	שטאַרכויוו
שטר־חצי־זכר	שטאַר־כאָצי־זאָכער
שטר־מכירה	שטאַר־מעכירע
שטרות	שטאָרעס
שטרים	שטאָרים
ש״י	שײַ
ש״י עולמות	שײַ אוילאָמעס,שײַ אוילעמעס
שיבוש	שיבעש
שיבושים	שיבושים
שיבֿעה	שיווע
שיבֿעה־טובֿי־העיר	שיווע־טוּווע־האָיִר
שיבֿעה־ימים	שיווע־יאַמים,שיווע־יאַמען
שיבֿעה־מדורי־גיהנום	שיווע־מעדורע־גענעם
שיבֿעה־עשׂר־בתּמוז	שיוואָסער־בעטאַמעז
שיבֿעים	שיווים
שיבֿעים־אומות	שיווים־אומעס
שיבֿעים־לשון	שיווים־לאָשן
שיבֿעים־לשונות	שיווים־לעשוינעס
שיבֿעת־ימי־המישתּה	שיוועס־יעמיי־האַמישטע
שיבֿרות־הלבֿ	שיוורעס־האַלעוו
שיבֿרי־כּלי	שיוורע־קיילע
שיבֿרי־לבֿ	שיוורעלעוו
שיבֿרי־לוחות	שיוורע־לוכעס
שיבֿת־ציון	שיוועס־ציִען
שידה	שידע
שידוך	שידעך
שידוכים	שידוכים
שיחיה לאורך ימים טובֿים אָמן	שעייִכיע לעוירעך יאָמים טויווים אָמיין
שיטה	שיטע
שיטות	שיטעס
שייגעץ	שייגעץ
שייך	שײַעך
שײַכות	שײַכעס
שיימע	שיימע
שיימעס	שיימעס
שיירה	שאַיאָרע
שיכּור	שיקער
שיכּורט	שיקערט
שיכּורטע	שיקערטע
שיכּורטעס	שיקערטעס
שיכּורים	שיקורים
שיכּורן	שיקערן
שיכּורס	שיקערס
שיכּורסט	שיקערסט
שיכּורערהייט	שיקערערהייט
שיכּחה	שיקכע
שיכּרות	שיקרעס
שילמען	שילעמען
שילשול	שילשל
שין	שין
שינוי	שינע
שינוי־מקום	שינע־מאָקעם
שינוי־שם	שינעשעם
שינויים	שינויִם
שיעבוד	שיבעד
שיעבוד־גלויות	שיבעד־גאָליעס
שיעור	שיִער
שיעורים	שיִורים
שיפּוע	שיפּוע
שיפּועים	שיפּויִם
שיפֿחה	שיפֿכע
שיפֿלות	שיפֿלעס
שיקוץ־משומם	שיקעץ־מעשוימעם
שיקרות	שיקרעס
שיר	שיר
שיר־המעלות	שיר־אַמײַלעס,שיר־האַמײַלעס
שיר־השירים	שיר־אַשירים,שיר־האַשירים
שירה	שירע
שיריים	שיראַיִם
שירים־ותּשבחות	שירים־וועטישבאָכעס
שישה סדרים	שישע סדאָרים,שישע סעדאָרים
שישה־נרות	שישע־ניירעס
שישי	שישי
שישים	שישים
שישים ריבוא	שישים ריבוי
שיתּין־נשמין	שיטין־נישמין
שכּורניצע	שיקאָרניצע
שכּורניק	שיקאָרניק
שכיבֿ־מרע	שכיוומעראַ
שכיח	שכיִעך
שכינה	שכינע
שכן	שאָכן
שכנא	שאַכנע
שכנה	שכיינע
שכנות	שכיינעס
שכנותדיק	שכיינעסדיק
שכנטע	שאָכנטע
שכנטעס	שאָכנטעס
שכנים	שכיינים
שכניש	שכייניש
שכנס	שאָכנס
של	שעל
של־יד	שעליאַד
של־ראָש	שעלראָש
שלא־	שעלוי
שלא־כּדרך־הטבֿע	שעלוי־קעדערעך־האַטעווע
שלא־לבֿייש	שעלוי־לעווײַעש
שלא־מן־הישובֿ	שעלוי־מין־האַייִשעוו
שלאָס־מם	שלאָסמעם
של״ה	שעלאַ
של״ה־הקדוש	שעלאַ־האַקאָדעש
שלווה	שאַלווע
שלוחא־דרבנן	שלוכע־דעראַבאָנען
שלום	שאָלעם
שלום־בית	שאָלעם־באַיִס
שלום־ושלווה	שאָלעם־וועשאַלווע
שלום־זכר	שאָלעם־זאָכער
שלום־לאַהובֿי־בריוו	שאָלעם־לאַהוּווי
שלום־עליכם	שאָלעם־אַלייכעם
שלום־עליכמס	שאָלעם־אַלייכעמס
שלום־עליכמען	שאָלעם־אַלייכעמען
שלומיאל	שלומיִעל
שלומס	שאָלעמס
שלומען	שאָלעמען
שלושים	שלוישים
שלח	שלאַך
שלח־מנות	שאַלאַכמאָנעס,שלאַכמאָנעס
שלי	שעלי
שלי שלי שלך שלך	שעלי שעלי שעלכאָ שעלאָך
שלי שלך שלך שלי	שעלי שעלאָך שעלכאָ שעלי
שליח	שעליִעך
שליח־מיוחד	שעליִעך־מעיוכעד
שליח־ציבור	שעליִעך־ציבער
שליחות	שליכעס
שליחי־ציבור	שלוכע־ציבער,שליכע־ציבער
שליחים	שלוכים,שליכים
שליחים־מיוחדים	שלוכים־מעיוכאָדים,שליכים־מעיוכאָדים
שליט״א	שליטע,שעליטע
שליטה	שליטע
שלים־שלימזל	שלימ־שלימאַזל
שלימזל	שלימאַזל
שלימזלניצע	שלימעזאַלניצע
שלימזלניק	שלימעזאַלניק
שליש	שאָלעש
שלישות	שלישעס
שלישי	שלישי
שלישים	שלישים
שלך	שעלאָך,שעלכאָ
שלל	שלאַל
שלמה	שלוימע
שלמה המלך	שלוימע האַמיילעך
שלמה המלכס	שלוימע האַמיילעכס
שלמהלע	שלוימעלע
שלמהלען	שלוימעלען
שלמהלעס	שלוימעלעס
שלמהן	שלוימען
שלמהס	שלוימעס
שלמות	שליימעס
שלש־סעודות	שאַלעשודעס
שלש־רגלים	שאָלעש־רעגאָלים
שלשה־דבֿרים	שלוישע־דוואָרים
שלשלת	שאַלשעלעס
שלשלת־היוחסין	שאַלשעלעס־האַיאָכסן
שלשת־ימי־הגבלה	שלוישעס־יעמיי־האַגבאָלע
שם	שעם
שם־דבֿר	שעמדאָווער
שם־הוויה	שעם־האַווײַע
שם־המפֿורש	שעם־האַמפֿוירעש
שם־טובֿ	שעמטאָוו
שם־רע	שעמראַ
שמא	שעמאַ
שמאי	שאַמײַ,שאַמע
שמד	שמאַד
שמד־שטיק	שמאַטשטיק
שמדיש	שמאַדיש
שמדן	שמאַדן
שמדניצע	שמאַדניצע
שמדניק	שמאַדניק
שמדעלניצע	שמאַדעלניצע
שמדעלניק	שמאַדעלניק
שמדקייט	שמאַדקייט
שמואל	שמועל
שמואל הנבֿיא	שמועל האַנאָווי
שמונה	שמוינע
שמונה־עשׂרה	שימענעסרע
שמונים	שמוינים
שמועה	שמוע
שמועות	שמועס
שמורה	שמורע
שמורה־מצה	שמורעמאַצע
שמורהניק	שמורעניק
שמות	שיימעס,שמויס
שמות־הטומאה	שמויס־האַטומע
שמיטה	שמיטע
שמיני	שמיני
שמיני־עצרת	שמינאַצערעס
שמינית־שבשמינית	שמיניס־שעבעשמיניס
שמיעה	שמיִע
שמירה	שמירע
שמן־זית	שעמען־זאַיִס
שמן־זיתדיק	שעמען־זאַיִסדיק
שמע־ישׂראל	שמאַ־ייִסראָעל
שמע־קולנו	שמאַ־קויליינו,שמאַקעליינע
שמעון	שימען
שמעון בר־יוחאי	שימען באַר־יעכײַ
שמעונס	שימענס
שמעונען	שימענען
שמעיה	שמײַע
שמעיהן	שמײַען
שמען	שעמען
שמץ	שעמעץ
שמריה	שמאַריע
שמריהו	שמאַריע
שמריהון	שמאַריען
שמריהוס	שמאַריעס
שמריהן	שמאַריען
שמריהס	שמאַריעס
שמשון	שימשן
שמשון הגיבור	שימשן האַגיבער
שמשון הגיבורס	שימשן האַגיבערס
שמשונס	שימשנס
שמשׂ	שאַמעס
שמשׂות	שאַמאָסעס
שמשׂטע	שאַמעסטע
שמשׂים	שאַמאָסים
שנדרן	שנאָדערן,שענאָדערן
שנה	שאָנע
שנה־טובֿה	שאָנע־טויווע
שנה־מעוברת	שאָנע־מעובערעס
שני	שניי
שני לוחות הברית	שניי לוכעס האַבריס
שני־למלך	שיינע־לעמיילעך
שני־למלכות	שיינע־לעמאַלכעס
שני־שבשלישי	שיינע־שעבעשלישי
שניאור	שנייער
שנים	שאָנים,שנאַיִם
שנית	שייניס,שיינעס
שנת	שנאַס
שנת־בצורת	שנאַס־באַצוירעס
ש״ס	שאַס
שס	שאַס
ש״ס־תּחינה	שאַסטכינע
שס״ה	שאַסאַ,שעסאַ
שס״ה גידין	שאַסאַ גידן,שעסאַ גידן
שעה	שאָ
שעה־מוצלחת	שאָ־מוצלאַכעס
שעהען	שאָען
שעות	שאָעס
שעטנז	שאַטנעז
שעיה	שײַע
שעיהן	שײַען
שעיהס	שײַעס
שער	שאַאַר
שער־בלאַט	שאַר־בלאַט
שער־האַשפּה	שאַאַר־האָאַשפּע
שערי־דמעות	שאַאַרע־דמאָעס
שערי־רחמים	שאַאַרע־ראַכמים
שערי־תּפֿילה	שאַאַרע־טפֿילע
שערים	שעאָרים
שעת־הדחק	שאַס־האַטכאַק
שעת־הכּושר	שאַס־האַקוישער
שעת־רצון	שאַס־ראָצן
שפֿוך־חמתך	שפֿויכאַמאָסכע,שפֿויך־כאַמאָסכאָ
שפֿיכת־דמים	שפֿיכעס־דאָמים
שפֿל	שאָפֿל
שפֿע	שעפֿע
שפֿרה	שיפֿרע
שפֿרהלע	שיפֿרעלע
שפֿרהלען	שיפֿרעלען
שפֿרהלעס	שיפֿרעלעס
שפֿרהן	שיפֿרען
שפֿרהס	שיפֿרעס
ש״ץ	שאַץ
שקאָץ	שקאָץ
שקאָצים	שקאָצים
שקיעה	שקיִע
שקיעת־החמה	שקיִעס־האַכאַמע
שקל	שעקל
שקלא־וטריא	שאַקלע־וועטאַריע
שקלים	שקאָלים
שקצים	שקאָצים
שקר	שעקער
שקר־וכּזבֿ	שעקער־וועקאָזעוו
שקר־ושלימזל	שעקער־וועשלימאַזל
שקרים	שקאָרים
שקרים־וכזבֿים	שקאָרים־אוכזאָווים
שקרן	שאַקרען
שקרנים	שאַקראָנים
שרבֿיט	שאַרוועט
שרגא	שראַגע
שרוי־בצער	שאָרע־בעצאַאַר
שרויה	שרוּיע
שרפּ״ט	שאַרפּאַט
שרץ	שערעץ
שרצים	שראָצים
ששת־ימי־בראשית	שיישעס־יעמיי־בריישעס
שתּדלן	שטאַדלען
שתּדלנות	שטאַדלאָנעס
שתּדלנטע	שטאַדלענטע
שתּדלנטעס	שטאַדלענטעס
שתּדלנים	שטאַדלאָנים
שתּדלנען	שטאַדלענען
שתּחיה	שעטיכיע
שתּיה	שטיִע
שתּיהן	שטיִען
שתּיקה	שטיקע
שתּיקה כּהודאה	שטיקע קעהוידאָע
שתּיקה כּהודאה דמיא	שטיקע קעהוידאָע דאַמיע
שתי־וערבֿ	שעסי־וואָערעוו
שׂ	סין
שׂאו־ידיכם	סעו־יעדייכעם
שׂונא	סוינע
שׂונא־בצע	סוינע־בעצע
שׂונא־ישׂראל	סוינע־ייִסראָעל
שׂונא־ציון	סוינע־ציִען
שׂונאטע	סוינעטע
שׂונאטעס	סוינעטעס
שׂונאי־בצע	סוינע־בעצע
שׂונאי־ישׂראל	סוינע־ייִסראָעל
שׂונאי־ציון	סוינע־ציִען
שׂונאים	סאָנים
שׂונאס	סוינעס
שׂטן	סאָטן
שׂטן־המקטרג	סאָטן־האַמעקאַטרעג
שׂטן־המשחית	סאָטן־האַמאַשכעס
שׂטן־מקטרג	סאָטן־מעקאַטרעג
שׂיחה	סיכע
שׂיחות	סיכעס
שׂיחת־חולין	סיכעס־כולין
שׂיחת־נשים	סיכעס־נאָשים
שׂימחה	סימכע
שׂימחה־ושׂשׂון	סימכע־וועסאָסן
שׂימחה־של־מיצווה	סימכע־שעל־מיצווע
שׂימחות	סימכעס
שׂימחת־בית־השואבֿה	סימכעס־בייס־האַשאָייווע
שׂימחת־מיצווה	סימכעס־מיצווע
שׂימחת־תּורה	סימכעס־טוירע
שׂין	סין
שׂינאה	סינע
שׂינאות	סינעס
שׂינאת־חינם	סינעס־כינעם
שׂינאת־ציון	סינעס־ציִען
שׂכיר־יום	סכיר־יאָם
שׂכירות	סכירעס
שׂכל	סייכל
שׂכל־הישר	סייכל־האַיאָשער
שׂכר	סכאַר
שׂכר־־טירחא	סכאַר־טירכע
שׂכר־הליכה	סכאַר־האַליכע
שׂכר־ועונש	סכאַר־וועוינעש
שׂכר־טירחה	סכאַר־טירכע
שׂכר־לימוד	סכאַר־לימעד
שׂכר־מלאָכה	סכאַר־מעלאָכע
שׂמח־בחלקו	סאָמייעך־בעכעלקע
שׂעיר	סעיִר
שׂעיר־לעזאָזל	סאָער־לאַזאָזל
שׂר	סאַר
שׂר־המלכות	סאַר־האַמאַלכעס,סאָרע־האַמאַלכעס
שׂר־המשקים	סאַר־האַמאַשקים
שׂרה	סאָרע
שׂרה בת־טובֿים	סאָרע באַס־טויווים
שׂרהלע	סאָרעלע
שׂרהלען	סאָרעלען
שׂרהלעס	סאָרעלעס
שׂרהן	סאָרען
שׂרהס	סאָרעס
שׂריד	סאָרעד
שׂריד־ופּליט	סאָרעד־אופּאָלעט
שׂרידי־פּליטה	סרידע־פּלייטע
שׂרידים	סרידים
שׂרים	סאָרים
שׂרף	סאָרעף
שׂרפֿה	סרייפֿע
שׂרפֿות	סרייפֿעס
שׂרפֿים	סראָפֿים
שׂרפֿים־ואופֿנים	סראָפֿים־וועאויפֿאַנים
שׂרפֿען	סאַרפֿען
שׂרפֿענען	סאַרפֿענען
שׂררה	סראָרע
שׂררהטע	סראָרעטע
שׂררהסטע	סראָרעסטע
שׂררות	סראָרעס
שׂרריש	סראָריש
שׂשׂון־ושׂימחה	סאָסן־וועסימכע
תּ	טאָף
תּאווה	טײַווע
תּאוות	טײַוועס
תּאומים	טוימים
תּבֿה	טייווע
תּבֿואה	טוווּע
תּבֿואות	טוווּעס
תּבֿונה	טוווּנע
תּבֿות	טייוועס
תּבֿיעה	טוויִע
תּבֿיעות	טוויִעס
תּג	טאַג
תּגין	טאַגן
תּהום	טהאָם
תּהומען	טהאָמען
תּהי נשמתה צרורה בצרור החיים	טעהי נישמאָסע צרורע ביצרויר האַכאַיִם
תּהי נשמתו צרורה בצרור החיים	טעהי נישמאָסע צרורע ביצרויר האַכאַיִם
תּהילים	טילים
תּובֿע	טויווייע
תּובֿע־בפּה	טויווייע־בעפּע
תּובֿעים	טויווים
תּובֿעת־בפּה	טויוואַאַס־בעפּע
תּוגר	טויגער
תּוהו־ובֿוהו	טויו־וואָווויו,טויעווויע
תּוו	טאָף
תּוך	טאָך
תּוך־	טאָך
תּוך־כּדי־דיבור	טאָך־קעדיידיבער
תּוך־כּל־התּוכות	טאָך־קאָלהאַטויכעס
תּוכחה	טויכעכע
תּוכן	טויכן
תּוכן־הענינים	טויכן־האָיִניאָנים
תּולדות	טאָלדעס
תּוספֿות	טויסעפֿעס
תּופֿס	טויפֿעס
תּורה	טוירע
תּורה וגדולה במקום אחד	טוירע אוגדולע בעמאָקעם עכעד
תּורה־כּולה	טוירע־קולע
תּורה־שבכּתבֿ	טוירע־שעביקסאַוו
תּורה־שבעל־פּה	טוירע־שעבאַלפּע
תּורת־חיים	טוירעס־כאַיִם
תּורת־לאָקשן	טוירעס־לאָקשן
תּורת־משה	טוירעס־מוישע
תּורת־משה אמת	טוירעס־מוישע עמעס
תּושבֿ	טוישעוו
תּושבֿים	טוישאָווים,טוישווים
תּזריע	טאַזריִע
תּזריע־מצורע	טאַזריִע־מעצוירע
תּחבולה	טאַכבולע
תּחום	טכום
תּחום־המושבֿ	טכום־האַמוישעוו
תּחום־שבת	טכום־שאַבעס
תּחיה	טיכיע
תּחילת	טכילעס
תּחינה	טכינע
תּחינות	טכינעס
תּחית־המתים	טכיִעס־המייסים
תּחלואים־רעים	טאַכלויִם־ראָיִם
תּחנון	טאַכנען
תּחנונים	טאַכנונים
תּחתּונים	טאַכטוינים
תּחתּונימלעך	טאַכטוינימלעך
תּחת	טאָכעס
תּחתל	טעכעסל
תּחתער	טעכעסער
תּיכּף	טייקעף
תּיכּף־ומיד	טייקעף־אומיִיאַד
תּימחה	טימכע
תּימחהס	טימכעס
תּימן	טיימען
תּינוק	טינעק
תּינוקות	טינויקעס
תּינוקות־של־בית־רבן	טינויקעס־שעל־בייסראַבאָן
תּינוקתל	טינויקעסל
תּיפֿלה	טיפֿלע
תּיקו	טייקו
תּיקון	טיקן
תּיקון־חצות	טיקן־כצאָס
תּיקון־טעות	טיקן־טאָעס
תּיקון־ליל־שבֿועות	טיקן־לייל־שוווּעס
תּיקון־שבֿועות	טיקן־שוווּעס
תּיקוני־זוהר	טיקונע־זויער
תּיקונים	טיקונים
תּירוץ	טערעץ
תּירוץ־מספּיק	טערעץ־מאַספּיק
תּירוצים	טערוצים
תּישבי	טישבי
תּישעה	טישע
תּישעה־באָבֿ	טישעבאָוו
תּישעים	טישים
תּישרי	טישרע
תּכונה	טכונע
תּכלית	טאַכלעס
תּכלית־שׂינאה	טאַכלעס־סינע
תּכליתים	טאַכלייסים
תּכלת	טכיילעס
תּכסיסי־מלחמה	טאַכסיסע־מילכאָמע
תּכריכים	טאַכריכים
תּכריכים־שטעך	טאַכריכים־שטעך
תּכשיט	טאַכשעט
תּכשיטים	טאַכשיטים
תּכשיטין	טאַכשיטן
תּל	טעל
תּל־אָבֿיבֿ	טעלאַוויוו
תּל־אַבֿיבֿ	טעלאַוויוו
תּל־עולם	טעל־אוילעם
תּלוי	טאָלע
תּלוי־בדבֿר	טאָלע־בעדאָווער
תּליה	טליִע
תּלין	טאַליען
תּלינים	טאַליאָנים
תּלמוד	טאַלמוד
תּלמוד־בבֿלי	טאַלמוד־באַוולי
תּלמוד־ירושלמי	טאַלמוד־יערושאַלמי
תּלמוד־תּורה	טאַלמעטוירע
תּלמיד	טאַלמעד
תּלמיד־חכם	טאַלמעד־כאָכעם
תּלמיד־מובֿהק	טאַלמעד־מוּוועק
תּלמידה	טאַלמידע
תּלמידי־חכמים	טאַלמידע־כאַכאָמים
תּלמידים	טאַלמידים
תּלמידים־מובֿהקים	טאַלמידים־מוּוואָקים
תּם	טאַם
תּם־ונישלם	טאַם־ווענישלעם
תּם־ונשלם	טאַם־ווענישלעם
תּמוז	טאַמעז
תּמונת־אות	טמונעס־אָס
תּמורה	טמורע
תּמיד	טאָמעד
תּמיה	טמיִע
תּמיכה	טמיכע
תּמימות	טמימעס
תּמעוואַטע	טאַמעוואַטע
תּמען	טאַמען
תּמצית	טאַמצעס
תּמציתים	טאַמצייסים
תּמר	טאָמער
תּמרה	טאַמאַרע
תּנא	טאַנע
תּנא־ברא	טאַנעבאַרע
תּנאַי	טנײַ
תּנאַי־גט	טנײַ־געט
תּנאָים	טאַנאָיִם,טנאָיִם
תּנו רבנן	טאָנו ראַבאָנאָן
תּנועה	טנוע
תּנועות	טנועס
תּנחום	טאַכנע,טאַנכעם
תּנך	טאַנאַך,טענאַך
תּנ״ך	טאַנאַך,טענאַך
תּנכיש	טאַנאַכיש
תּנצב״ה	טאַנאַצבע,טענאַצווע
תּענוג	טײַנעג
תּענוגים	טײַנוגים
תּענית	טאָנעס
תּענית־ציבור	טאַנעס־ציבער
תּענית־תּשובֿה	טאַנעס־טשוּווע
תּעניתים	טאַנייסים
תּפֿארת	טיפֿערעס
תּפֿוס	טאָפֿעס
תּפֿוצות־האָרץ	טפֿוצעס־האָאָרעץ
תּפֿוצות־ישׂראל	טפֿוצעס־ייִסראָעל
תּפֿילה	טפֿילע
תּפֿילה־בציבור	טפֿילע־בעציבער
תּפֿילה־זכּה	טפֿילע־זאַקע
תּפֿילות	טפֿילעס
תּפֿילין	טפֿילן
תּפֿילת־הדרך	טפֿילעס־האַדערעך
תּפֿיסה	טפֿיסע
תּפֿיסהניק	טפֿיסעניק
תּפֿיסות	טפֿיסעס
תּפֿסן	טאַפֿסן
תּפֿסנים	טאַפֿסאָנים
תּפֿסען	טאַפֿסען
תּפֿסענען	טאַפֿסענען
תּצוה	טעצאַווע
תּ״ק	טאַק
תּקומה	טקומע
תּקופֿה	טקופֿע
תּקופֿות	טקופֿעס
תּקופֿת־טבֿת	טקופֿעס־טייוועס
תּקופֿת־ניסן	טקופֿעס־ניסן
תּקופֿת־תּישרי	טקופֿעס־טישרע
תּקופֿת־תּמוז	טקופֿעס־טאַמעז
תּקיעה	טקיִע
תּקיעה־גדולה	טקיִע־גדוילע
תּקיעות	טקיִעס
תּקיעת־כּף	טקיִעס־קאַף
תּקיף	טאַקעף
תּקיף־בדעתּו	טאַקעף־בעדאַטע
תּקיפֿות	טקיפֿעס
תּקיפֿים	טקיפֿים
תּקלה	טעקאָלע
תּקנה	טאַקאָנע
תּקנות	טאַקאָנעס
תּרבותּ־שול	טאַרבוט־שול
תּרבות	טאַרבעס
תּרבות־שול	טאַרבוט־שול,טאַרבוס־שול
תּרגום	טאַרגעם
תּרגום־אונקלוס	טאַרגעם־אונקלעס
תּרגום־השיבֿעים	טאַרגעם־האַשיווים
תּרגום־יונתן	טאַרגעם־יוינעסן
תּרגום־לשון	טאַרגעם־לאָשן
תּרגום־שני	טאַרגעם־שייני
תּרומה	טרומע
תּרומות	טרומעס
תּרועה	טרוע
תּרועות	טרועס
תּרופֿה	טרופֿע
תּרופֿות	טרופֿעס
תּרח	טעראַך
תּרחטע	טערעכטע
תּרי״ג מיצוות	טאַריאַג מיצוועס
תּרנגול	טאַרנעגל
תּרנגולים	טאַרנעגוילים
תּרעומות	טאַרומעס
תּרפּ״ט	טאַרפּאַט
תּרפּ״ט אַלפֿים	טאַרפּאַט אַלאָפֿים
תּרתּי־דסתרי	טאַרטע־דעסאַסרע
תּשבורת	טישבוירעס
תּשבחות	טישבאָכעס
תּשואות־חן	טשועס־כיין
תּשובֿה	טשוּווע
תּשובֿה־ברורה	טשוּווע־ברורע
תּשובֿות	טשוּוועס
תּשוקה	טשוקע
תּשוקות	טשוקעס
תּשליך	טאַשלעך
תּשמיש	טאַשמעש
תּשמיש־המיטה	טאַשמעש־האַמיטע
תּשמישי־קדושה	טאַשמישע־קדושע
תּשר״ק	טאַשראַק
תּתחדש	טיסכאַדעש
תוו	סאָף
