אַאַווע	אַהבֿה
אַאַוועס־האַבריִעס	אַהבֿת־הבריות
אַאַוועס־האַמאָקעם	אַהבֿת־המקום
אַאַוועס־ייִסראָעל	אַהבֿת־ישׂראל
אַאַוועס־נעפֿעש	אַהבֿת־נפֿש
אַאַווע־ראַבע	אַהבֿה־רבה
אַבוהאַוו	אַבוהבֿ
אַבע	אַבא
אַגאָדע	אַגדה
אַגאָדעס	אַגדות
אַגאַדעטע	אַגדתּא
אַגאַדעטעס	אַגדתּות
אַגאָלע	עגלה
אַגאָלעס	עגלות
אַגודע	אַגודה
אַגודעס	אַגודות
אַגודעניק	אַגודהניק
אַגודעניקעס	אַגודהניקעס
אַגודעס־ייִסראָעל	אַגודת־ישׂראל
אַגונים	עגונים
אַגונע	עגונה
אַגונעס	עגונות
אָגל־וועעסמעך	אָגיל־ואשׂמח
אָג־מיילעך־האַבאָשן	עוג־מלך־הבשן
אַגמעס־נעפֿעש	עגמת־נפֿש
אַגמעס־נעפֿעשן	עגמת־נפֿשן
אָגן	עגון
אַגעוו	אַגבֿ
אַגעוו־אורכע	אַגבֿ־אורחא
אַגעוו־אורכעדיק	אַגבֿ־אורחאדיק
אַד	עד
אָדאָם	אָדם
אַדאָמע	אַדמה
אַד־בלי־דײַ	עד־בלי־די
אַד־בעלי־דײַ	עד־בלי־די
אַד־גמירע	עד־גמירא
אַד־האַיאָם־האַזע	עד־היום־הזה
אַד־הײַעם	עד־היום
אַדוין־אוילעם	אַדון־עולם
אַדויני	אַדוני
אַדויניינו מויריינו וועראַביינו	אַדוננו מורנו ורבנו
אַדוינים	אַדונים
אַדוינים־האַגדוילים	אַדונים־הגדולים
אַדוישעם	ה׳
אַד־יאַאַווויר־זאַאַם	עד־יעבֿור־זעם
אַדײַעם	עד־היום
אַדיר	אַדיר
אַדירים	אַדירים
אַד־כאַצי־האַמאַלכעס	עד־חצי־המלכות
אַד־כאָרמע	עד־חרמה
אַד־לאַפּאַק	עד־לפּ״ק
אַד־לאַשאָמאַיִם	עד־לשמים
אַד־ליפּראַט־קאָטן	עד־לפּרט־קטן
אַד־ליפּרוטע־קטאַנע	עד־לפּרוטה־קטנה
אַד־לעוו־האַשאָמאַיִם	עד־לבֿ־השמים
אַד־לעוו־שאָמאַיִם	עד־לבֿ־שמים
אַד־לעכעזשבם	עד־לחשבון
אַד־לעכעזשבן	עד־לחשבון
אַד־מאָסײַ	עד־מתי
אַדמאָר	אַדמו״ר
אַד־מייע־וועעסרים	עד־מאה־ועשׂרים
אַד־מייע־וועעסרים־שאָנע	עד־מאה־ועשׂרים־שנה
אָדן	אָדון
אָדן־בעפֿאָקדעכאָ	אָדון־בפֿקדך
אָדן־האַגאָדל	אָדון־הגדול
אַד־סאָף־קאָלהאַדוירעס	עד־סוף־כּל־הדורות
אָדעם	אָדם
אָדעמס	אָדמס
אָדעמען	אָדמען
אָדעם האָרישן	אָדם הראשון
אָדער	אָדר
אַדעראַבע	אַדרבא
אַדעראַבע	אַדרבה
אַדעראַבע־וועאַדעראַבע	אַדרבה־ואַדרבה
אַדעראַבע־וועאַדעראַבע	אַדרבא־ואַדרבא
אָדער אַלעף	אָדר א׳
אָדער בייס	אָדר ב׳
אָדער ווייאָדער	אָדר ואָדר
אַד־קאַן	עד־כּאַן
אַד־קאַן אָמרים בעשאַבעס־האַגאָדל	עד־כּאַן אומרים בשבת־הגדול
אַד־קיקער־לעכעם	עד־כּיכּר־לחם
אַדראַבע	אַדרבא
אַדראַבע	אַדרבה
אַהאַווע	אַהבֿה
אַהאַוועס־האַבריִעס	אַהבֿת־הבריות
אַהאַוועס־האַמאָקעם	אַהבֿת־המקום
אַהאַוועס־ייִסראָעל	אַהבֿת־ישׂראל
אַהאַוועס־נעפֿעש	אַהבֿת־נפֿש
אַהאַווע־ראַבע	אַהבֿה־רבה
אָהאָלעס	אָהלות
או…	ו…
אובאָרים	עוברים
אובער	עובר
אָוו	אָבֿ
אַוואָדים	עבֿדים
אַוואָדים־האָיִנו	עבֿדים־היינו
אַוואָדים־קנאַאַנים	עבֿדים־כּנענים
אַוואָדים־קנײַנים	עבֿדים־כּנענים
אָוואַדיע	עבֿדיה
אַוואַדע	אַוודאי
אַוואָנים־טויוועס	אבֿנים־טובֿות
אַוו־בעזדן	אַבֿ־בית־דין
אַוו־בעזן	אַבֿ־בית־דין
אַוודעס	עבֿדות
אָוודע־קויכאָווים־אומאַזאָלעס	עובֿדי־כּוכבֿים־ומזלות
אַוו־האָראַכמים	אַבֿ־הרחמים
אוּוודע	עובֿדא
אוּוודע	עובֿדה
אוּוודעס	עובֿדות
אַוווידע	עבֿודה
אַוווידעס	עבֿודות
אַוווידע־בזוּיע	עבֿודה־בזויה
אַוווידע־זאָרע	עבֿודה־זרה
אַוווידע־זאָרעס	עבֿודה־זרהס
אַוווידעס־בזוּיעס	עבֿודות־בזויות
אַוווידעס־האַבוירע	עבֿודת־הבורא
אַוווידעס־האַקוידעש	עבֿודת־הקודש
אַוווידעס־האַשעם	עבֿודת־השם
אַוווידעס־פּערעך	עבֿודת־פּרך
אַוווינעס	עוונות
אוּווכיין	ובֿכן
אַווי־אַוואָס־האַטומע	אַבֿי־אַבֿות־הטומאה
אַוויגדער	אַבֿיגדור
אַוויגדערס	אַבֿיגדורס
אַוויגדערן	אַבֿיגדורן
אַוויידע	אַבֿדה
אַוויידעס	אַבֿדות
אַוויילים	אַבֿלים
אַוויילעס	אַבֿלות
אַווי־יעסוימים	אַבֿי־יתומים
אַוויירע	עבֿירה
אַוויירעס	עבֿירות
אַוויירעס שעביין־אָדעם־לאַמאָקעם	עבֿירות שבין־אָדם־למקום
אַוויירעס שעביין־אָדעם־לעכאַוויירע	עבֿירות שבין־אָדם־לחבֿרו
אָווינו־מאַלקיינו	אָבֿינו־מלכּנו
אַווישאָלעם	אַבֿישלום
אַווישאָלעמס	אַבֿישלומס
אַווישאָלעמען	אַבֿישלומען
אָוול	אָבֿל
אָוול־וואַכאַפֿוּי־ראָש	אָבֿל־וחפֿוי־ראָש
אָוולטע	אָבֿלטע
אָוולטעס	אָבֿלטעס
אַוולע	עוולה
אַוולעס	עוולות
אָוון	עוון
אַוונע־נעגעף	אבֿני־נגף
אָוועס	אָבֿות
אָוועס־אַווויסאָוו	אָבֿות־אַבֿותיו
אָוועס־אַווויסיינו	אָבֿות־אַבֿותינו
אַווער	אַוויר
אָווער	עבֿר
אָווער־זמאַן	עבֿר־זמן
אַווערן	אַווירן
אַווערסט	אַווירסט
אַווערט	אַווירט
אַווערנדיק	אַווירנדיק
געאַווערט	געאַווירט
אַווראָהאָם אָווינו	אַבֿרהם אָבֿינו
אַווראָהאָם אָווינוס	אַבֿרהם אָבֿינוס
אַווראָם	אַבֿרהם
אַווראָמס	אַבֿרהמס
אַווראָמען	אַבֿרהמען
אַווראָם אָווינו	אַבֿרהם אָבֿינו
אַווראָם אָווינוס	אַבֿרהם אָבֿינוס
אַוורעמל	אַבֿרהמל
אַוורעמלס	אַבֿרהמלס
אַוורעמלען	אַבֿרהמלען
אַוושאָלעם	אַבֿשלום
אַוושאָלעמס	אַבֿשלומס
אַוושאָלעמען	אַבֿשלומען
אוידעף	עודף
אויהאָלים	אוהלים
אויהעוו־בעצע	אוהבֿ־בצע
אויהעוו־ייִסראָעל	אוהבֿ־ישׂראל
אויהעווע־ייִסראָעל	אוהבֿי־ישׂראל
אויהעל	אוהל
אויוועד־קויכאָווים־אומאַזאָלעס	עובֿד־כּוכבֿים־ומזלות
אויווער	עובֿר
אויווער־אוּוואָטל	עבֿר־ובֿטל
אויווער־אַל־דאַס	עובֿר־על־דת
אויווערבאָטל	עובֿר־בטל
אויווערבאָטעלן	עובֿר־בטלן
אויווערבאָטעלע	עובֿר־בטלע
אויווערבאָטעלער	עובֿר־בטלער
אויווערבאָטלס	עובֿר־בטלס
אויווערבאָטלניצע	עובֿר־בטלניצע
אויווערבאָטלניצעס	עובֿר־בטלניצעס
אויווערבאָטלניק	עובֿר־בטלניק
אויווערבאָטלניקעס	עובֿר־בטלניקעס
אויווער־לעסויכער	עובֿר־לסוחר
אויווער־קרישמע	עובֿר־קריאת־שמע
אויווער־שוווּע	עובֿר־שבֿועה
אויזער	עוזר
אויזערל	עוזרל
אויזערס	עוזרס
אויזערן	עוזרן
אויכער־ייִסראָעל	עוכר־ישׂראל
אוילאָמעס	עולמות
אוילים	עולים
אוילע	עולה
אוילע־טמימע	עולה־תּמימה
אוילע־יאָפֿע	עולה־יפֿה
אוילע־לאַטוירע	עולה־לתּורה
אוילע־ליגדולע	עולה־לגדולה
אוילעם	עולם
אוילעם־אומלויע	עולם־ומלואו
אוילעם־גוילעם	עולם־גולם
אוילעם־האָאַצילעס	עולם־האַצילות
אוילעם־האַבע	עולם־הבא
אוילעם־האַדימיען	עולם־הדמיון
אוילעם־האַזימרע	עולם־הזימרה
אוילעם־האַזע	עולם־הזה
אוילעם־האַזעניצע	עולם־הזהניצע
אוילעם־האַזעניצעס	עולם־הזהניצעס
אוילעם־האַזעניק	עולם־הזהניק
אוילעם־האַזעניקעס	עולם־הזהניקעס
אוילעם־האַטאַכטן	עולם־התּחתּון
אוילעם־האַטויע	עולם־התּוהו
אוילעם־האַנעגינע	עולם־הנגינה
אוילעם־האָעליען	עולם־העליון
אוילעם־האָעמעס	עולם־האמת
אוילעם־האָפֿעך	עולם־הפֿוך
אוילעם־האַצאַכצאָכעס	עולם־הצחצחות
אוילעם־האַשאָפֿל	עולם־השפֿל
אוילעם־האַשעקער	עולם־השקר
אוילעם־מאָלע	עולם־מלא
אוילעם־עליען	עולם־עליון
אוילעמעס	עולמות
אוילעמעס־האָעליוינים	עולמות־העליונים
אוילעמעס־עליוינים	עולמות־עליונים
אוילעם־קאָטן	עולם־קטן
אוילעס	עולות
אוילע־רעגל	עולה־רגל
אוימעד־אַל־דאַטע	עומד־על־דעתּו
אוימעד־בעדיבורע	עומד־בדיבורו
אוימעד־בעמירדע	עומד־במרדו
אוימעד־בעניסויען	עומד־בנסיון
אוימער	עומר
אוימער־וועויסע	אומר־ועושׂה
אוינעג	עונג
אוינעג־רוכני	עונג־רוחני
אוינעג־שאַבעס	עונג־שבת
אוינעס	אונס
אוינעש	עונש
אויסבאַטלען	אויסבטלען
אויסגעבאַטלט	אויסגעבטלט
אויסבאַטלענדיק	אויסבטלענדיק
אויסטײַנען	אויסטענהן
אויסגעטײַנעט	אויסגעטענהט
אויסטײַנענדיק	אויסטענהנדיק
אויסיעס	אותיות
אויסיעסלעך	אותיותלעך
אויסיעס מאַכקימעס	אותיות מחכּימות
אויסיעס־מערובאָעס	אותיות־מרובעות
אויססאַדערן	אויססדרן
אויסגעסאַדערט	אויסגעסדרט
אויססאַדערנדיק	אויססדרנדיק
אויסע־איש	אותו־איש
אויסע־האָיִש	אותו־האיש
אויסע־האַמאָקעם	אותו־המקום
אויסע־מאָקעם	אותו־מקום
אויסעס־אומאָפֿסים	אותות־ומופֿתים
אויסעק	עוסק
אויסעק־בעמיצווע	עוסק־במיצווה
אויסעק־בעצאָרכע־ציבער	עוסק־בצרכי־ציבור
אויסע־רעגע	אותו־רגע
אויסע־שאָלעם	עושׂה־שלום
אויסע־שאָלעם־בימרוימאָוו	עושׂה־שלום־במרומיו
אויסשייגעצן	אויסשגצן
אויעוו־בעצע	אוהבֿ־בצע
אויעוו־ייִסראָעל	אוהבֿ־ישׂראל
אויעווע־ייִסראָעל	אוהבֿי־ישׂראל
אויעל	אוהל
אויפֿאַנים	אופֿנים
אויפֿן	אופֿן
אויפֿעס	עופֿות
אויפֿעס־טמעיִם	עופֿות־טמאים
אויפֿעס־טעהוירים	עופֿות־טהורים
אויצער	אוצר
אויצרעס	אוצרות
אויקעץ	עוקץ
אויקער	עוקר
אויקער־האָרים	עוקר־הרים
אויקער־מין־האַשוירעש	עוקר־מן־השורש
אויר	אור
אויר־האַגאָנעז	אור־הגנוז
אור־קאַזדים	אור־כּשׂדים
אויר לאַיעהודים	אור ליהודים
אוירעך	אורח
אוירעך־האָגן	אורח־הגון
אוירעכטע	אורחטע
אוירעכטעס	אורחטעס
אוירעך־כאַיִם	אורח־חיים
אוישער	עושר
אוישערס	עושרס
אוכדוימע	וכדומה
אולײַ־יעראַכעם	אולי־ירחם
אולמײַ נאַפֿקע־מינע	ולמאַי נפֿקא־מינה
אומבעטאַרבעסדיק	אומבתּרבותדיק
אומבעטאַרבעסדיקן	אומבתּרבותדיקן
אומבעטאַרבעסדיקע	אומבתּרבותדיקע
אומבעטאַרבעסדיקער	אומבתּרבותדיקער
אומבעראַכמאָנעס	אומברחמנות
אומבעראַכמאָנעסדיק	אומברחמנותדיק
אומבעראַכמאָנעסדיקן	אומברחמנותדיקן
אומבעראַכמאָנעסדיקע	אומברחמנותדיקע
אומבעראַכמאָנעסדיקער	אומברחמנותדיקער
אומכיין	אומחן
אומנעס	אומנות
אומנעסן	אומנותן
אומע	אומה
אומע־וועלאָשן	אומה־ולשון
אומען	אומן
אומען־יאַד	אומן־יד
אומעס	אומות
אומעס־האָוילעם	אומות־העולם
אונטערגאַנווענען	אונטערגנבֿענען
אונטערצוגאַנווענען	אונטערצוגנבֿענען
אונטערגעגאַנוועט	אונטערגעגנבֿעט
אונטערגאַנווענענדיק	אונטערגנבֿענענדיק
אונטערקאָל	אונטערקול
ווענוימער אָמיין	ונאמר אָמן
אונסאַנע־טויקעף	ונתנה־תּוקף
אוקצין	עוקצין
אורווע פּאָרעך	עורבֿא פּרח
אורים־וועטומים	אורים־ותּומים
אוריִעל	אוריאל
אוריִעלס	אוריאלס
אוריִעלן	אוריאלן
אושפּיזן	אושפּיזין
אַזאָזל	עזאזל
אַזהאָרע	אַזהרה
אַזהאָרעס	אַזהרות
אַזויוו־טאַזויוו	עזובֿ־תּעזובֿ
אָז־יאָשער	אָז־ישיר
אַזעס	עזות
אַזעסקייט	עזותקייט
אַזעסדיק	עזותדיק
אַזעסדיקער	עזותדיקער
אַזעסדיקע	עזותדיקע
אַזעסדיקן	עזותדיקן
אַזעסדיקס	עזותדיקס
אַזעס־מעכוצעף־פּאָנעם	עזות־מחוצף־פּנים
אַזעס־פּאָנעם	עזות־פּנים
אַזעס־פּאָנעמטע	עזות־פּנימטע
אַזעס־פּאָנעמטעס	עזות־פּנימטעס
אַזעס־פּענעמער	עזות־פּנימער
אַזריִעל	עזריאל
אַזריִעלס	עזריאלס
אַזריִעלן	עזריאלן
אַטאָ	אַתּה
אַטאָ־בעכאַרטאָנו	אַתּה־בחרתּנו
אַטאָ־בעכאַרטאָנוניק	אַתּה־בחרתּנוניק
אַטאָ־בעכאַרטאָנוניקעס	אַתּה־בחרתּנוניקעס
אַטאָ־האָרייסאָ	אַתּה־הראית
אַטאָ־האָרייסאָלע	אַתּה־הראיתלע
אַטאָ־וועכאַרטאָנו	אַתּה־בֿחרתּנו
אַטאָרע	עטרה
אַטאָרעס	עטרות
אַטיקע	עתּיקא
אַטע	אַתּה
אַטעק־יוימין	עתּיק־יומין
איבן־פּעקודע	אבן־פּקודה
איבעד	איבוד
איבער	עיבור
איבער־יאָר	עיבור־יאָר
איבערכאַזערן	איבערחזרן
איבערגעכאַזערט	איבערגעחזרט
איבערכאַזערנדיק	איבערחזרנדיק
איגולים	עיגולים
איגל	עיגול
איווריט	עבֿריתּ
איוורע	עבֿרי
איוורע־טײַטש	עבֿרי־טײַטש
איזאָוון	עזבֿון
איזוווינעס	עזבֿונות
איזרעעל	יזרעאל
איזרעעלס	יזרעאלס
איזרעעלן	יזרעאלן
אייבערהאַזבאָרע	אייבערהסברה
אייבערהאַזבאָרעס	אייבערהסברות
אייבערהאַסבאָרע	אייבערהסברה
אייבערהאַסבאָרעס	אייבערהסברות
אייבערקאָל	אייבערקול
אייגל	עגל
אייגל־האַזאָהעוו	עגל־הזהבֿ
אייד	עד
איידוּיעס	עדויות
איידים	עדים
אייד־מיפּי־אייד	עד־מפּי־עד
איידע	עדה
איידעס	עדות
איידעסטע	עדותטע
איידעסטעס	עדותטעס
איידעסן	עדותן
איידעסט	עדותט
געיידעסט	געעדותט
געאיידעסט	געעדותט
איידעסנדיק	עדותנדיק
איידעסשאַפֿט	עדותשאַפֿט
איידעסשאַפֿטן	עדותשאַפֿטן
איידע־ריִע	עדי־ראיה
אייד־ריִע	עד־ראיה
אייוול־וועסוגע	אבֿל־ותוגה
אייווער	אבֿר
אייווער־מין־האַכײַ	אבֿר־מן־החי
אייוורים	אבֿרים
אייזער־קענעגדע	עזר־כּנגדו
אייכע	איכה
אייכעס	איכות
אייל	אל
אייל־מאָלע־ראַכמים	אל־מלא־רחמים
אייל־נעקאָמעס	אל־נקמות
איילע טאָלדעס	אלה תּולדות
אײַלעניס	אַילונית
אײַלעניסן	אַילוניתן
אייל־ראַכום־וועכאַנון	אל־רחום־וחנון
איימע	אימה
איימעדיק	אימהדיק
איימעדיקער	אימהדיקער
איימעדיקע	אימהדיקע
איימעדיקן	אימהדיקן
איימעדיקס	אימהדיקס
איימעס־מאָוועס	אימת־מוות
איימעסע־דעציבורע	אימתא־דציבורא
איימעק	עמק
איימעק־איזרעעל	עמק־יזרעאל
איימעק־האַבאָכע	עמק־הבכה
איין	אין
איין אוינעס	אין אונס
איין אייצע וועיין טוווּנע	אין עצה ואין תּבֿונה
איינאַיִם	עינים
איין־באַיִס	אין־בית
איין־בריירע	אין־ברירה
אײַנגעכוישעכט	אײַנגעחושכט
אײַנגעכוישעכטן	אײַנגעחושכטן
אײַנגעכוישעכטע	אײַנגעחושכטע
אײַנגעכוישעכטער	אײַנגעחושכטער
איינהאָרעניצע	עין־הרעניצע
איינהאָרעניצעס	עין־הרעניצעס
איינהאָרעניק	עין־הרעניק
איינהאָרע	עין־הרע
איינהאָרעניקעס	עין־הרעניקעס
איין־יאַנקעוו	עין־יעקבֿ
איין יויצע וועיין באָ	אין יוצא ואין באָ
אײַנכאַזערן	אײַנחזירן
אײַנגעכאַזערט	אײַנגעחזירט
אײַנכאַזערנדיק	אײַנחזירנדיק
איין כאָכמע וועיין טוווּנע נעגעד	אין חכמה ואין תּבֿונה נגד
איין־לי	אין־לי
איין־לעשאַער	אין־לשער
איין־לעשאַער וועיין־לעסאַפּער	אין־לשער ואין־לספּר
איין מאַזל לעייִסראָעל	אין מזל לישׂראל
איינסאָף	אין־סוף
איינע־ייִסראָעל	אינו־ישׂראל
איינענו	איננו
איינע־נירע	אינו־ניראה
איינע־נירעס	אינו־ניראהס
איין קאָל וועיין אוינע	אין קול ואין עונה
אייס־כעדווע	עת־חדווה
אייס־לאַאַסויס	עת־לעשׂות
אייסעוו	עשׂו
אייסעווס	עשׂוס
אייסעוון	עשׂון
אייסעק	עסק
אייסעקן	עסקן
אייס־צאָרע	עת־צרה
אייס־צאָרע־לעיאַנקעוו	עת־צרה־ליעקבֿ
אייס־ראָצן	עת־רצון
אײַען	ע
אײַען	עין
אייפֿעד	אפֿוד
אייפֿעלע	עופֿעלע
אייפֿעלעך	עופֿעלעך
אייץ־האַדאַאַס	עץ־הדעת
אייץ־האַכאַיִם	עץ־החיים
אייצים־וועיִלאָנעס	עצים־ואילנות
אייץ־כאַיִם	עץ־חיים
אייצע	עצה
אייצע־טויווע	עצה־טובֿה
אייצען	עצהן
אייצעסט	עצהסט
אייצעט	עצהט
געייצעט	געעצהט
אייצענדיק	עצהנדיק
אייצעס	עצות
אייקעוו	עקבֿ
איירוּווים	עירובֿים
איירוּוון	עירובֿין
איירוּווין	עירובֿין
איירעוו	עירובֿ
איירעוון	עירובֿן
איירעוו־טאַוושילין	עירובֿ־תּבֿשילין
איירעוו־טאַפֿשילן	עירובֿ־תּבֿשילין
איירעוו־טכומין	עירובֿ־תּחומין
איירעוו־טכומען	עירובֿ־תּחומין
אייש־לעהאָווע	אש־להבֿה
איישעס־איש	אשת־איש
איישעס־אישניצע	אשת־אישניצע
איישעס־אישניצעס	אשת־אישניצעס
איישעס־אישניק	אשת־אישניק
איישעס־אישניקעס	אשת־אישניקעס
איישעס־כאַיִל	אשת־חיל
אילויִם	עילויים
אילויִש	עילוייִש
אילויִשן	עילוייִשן
אילויִשע	עילוייִשע
אילויִשער	עילוייִשער
אילע	עילוי
אים	אם
אים	עם
אימאָנועל	עמנואל
אימאָנועלס	עמנואלס
אימאָנועלן	עמנואלן
אימאָעס	אמהות
אים־ייִרצע־האַשעם	אם־ירצה־השם
אים לוי אַכשאָוו איימאָסײַ	אם לא עכשיו אימתי
אים לוי יאָיִל לוי יאַזיק	אם לא יועיל לא יזיק
אים־קאָל־האַנעאָרים	עם־כּל־הנערים
אימקיין	אם־כּן
אַיִן־בעאַיִן	עין־בעין
אינויִם	עינויים
אינויִם־קאָשים	עינויים־קשים
אַיִן טאַכעס אַיִן	עין תּחת עין
איניאָנים	ענינים
איניען	ענין
אינע	עינוי
איסאָמער	איתמר
איסורים	איסורים
איסיִיִ	איסיי
איסיִיִם	איסיים
איסער	איסור
איסער	איסר
איסרע־כאַג	איסרו־חג
איִעוו	איובֿ
איִעוו־בסורע	איובֿ־בשׂורה
איִעוו־בסורעס	איובֿ־בשׂורות
איִעוו־פּסורע	איובֿ־בשׂורה
איִעוו־פּסורעס	איובֿ־בשׂורות
איִער	אייר
איפּכע־מיסטאַברע	איפּכא־מסתּברא
איפּכע־מיסטאַברעניק	איפּכא־מסתּבראניק
איפּכע־מיסטאַברעניקעס	איפּכא־מסתּבראניקעס
איפּכע־מיסטאַברעניצע	איפּכא־מסתּבראניצע
איפּכע־מיסטאַברעניצעס	איפּכא־מסתּבראניצעס
איפּעש	עיפּוש
איצטעלע־דעראַבאָנען	איצטלא־דרבנן
איקוּווים	עיכּובֿים
איקעוו	עיכּובֿ
איקער	עיקר
איקער־	עיקר־
איקער־האָיִקרים	עיקר־העיקרים
איקער־האַמײַסע	עיקר־המעשׂה
איקער־שאָכאַכטי	עיקר־שכחתּי
איקרים	עיקרים
איר־האַבירע	עיר־הבירה
איר־האַמיקלעט	עיר־המיקלט
איר־האַמלוכע	עיר־המלוכה
איר־האַמעלוכע	עיר־המלוכה
אירוווּוויע	ערבֿובֿיה
איר־וועיים	עיר־ואם
איר־וועיים־בעיִסראָעל	עיר־ואם־בישׂראל
איר־מיקלעט	עיר־מיקלט
איש	איש
איש־יאָשער	איש־ישר
איש־כאָשעוו	איש־חשובֿ
איש־מעהיימען	איש־מהימן
איש־מעפּי־איש	איש־מפּי־איש
אישע	אישה
אישע־צנוע	אישה־צנועה
אַכאַד־האָאָם	אַחד־העם
אַכאָוו	אַחאָבֿ
אַכאַס־וועאַכאַס	אַחת־ואַחת
אַכאַשוויירעש	אַחשוורוש
אַכאַשטראָנים	אַחשתּרנים
אַכבאָרים	עכברים
אַכבער	עכבר
אַכבעראָש	עכבראָש
אַכבעראָשים	עכבראָשים
אַכדעס	אַחדות
אַכדעס־האַבוירע	אַחדות־הבורא
אַכויראַיִם	אַחוריים
אַכוץ	אַחוץ
אַכזאָרים	אַכזרים
אַכזאָריעס	אַכזריות
אַכזער	אַכזר
אָכי	אָחי
אַכיזע	אַחיזה
אַכיזעס	אַחיזות
אַכיזעס־איינאַיִם	אַחיזת־עינים
אַכיינו־בניי־ייִסראָעל	אַחינו־בני־ישׂראל
אַכילע	אַכילה
אַכילע־אושטיִע	אַכילה־ושתּיה
אַכים־לעצאָרע	אַחים־לצרה
אַכלאָנים	אַכלנים
אַכלען	אַכלן
אַכלען	אַכלען
אַכל	אַכל
אַכלסט	אַכלסט
אַכלט	אַכלט
געאַכלט	געאַכלט
אַכלענדיק	אַכלענדיק
אָך־לעצאָרע	אָח־לצרה
אַכסאַניע	אַכסניא
אַכסאַניע	אַכסניה
אַכסאַניעס	אַכסניות
אָכער	אָחור
אַכער	אַחר
אַכער־האַמײַסע	אַחר־המעשׂה
אַכער־מייע־שאָנים	אַחר־מאה־שנים
אָכערס	אָחורס
אַכרוינים	אַחרונים
אַכריי־מויס	אַחרי־מות
אַכרײַעס	אַחריות
אַכריי־קיכלויס־האַקל	אַחרי־כּכלות־הכּל
אַכרען	אַחרון
אַכרען אַכרען כאָוויוו	אַחרון אַחרון חבֿיבֿ
אַכרען־שעל־פּייסעך	אַחרון־של־פּסח
אַכרעס־האַיאָמים	אַחרית־הימים
אַל	אַל
אַל	על
אָל	עול
אָלן	עולן
אַלאַכסן	אַלכסון
אַלאַכסנס	אַלכסונס
אַלאַכעס־קאַמע־וועקאַמע	על־אַחת־כּמה־וכּמה
אַלאָס־האַשאַכער	עלות־השחר
אַל־אַפּי וועאַל־כאַמאָסי	על־אַפּי ועל־חמתי
אַל־אַפּע וועאַל־כאַמאָסע	על־אַפּו ועל־חמתו
אַל־אַפּעם וועאַל־כאַמאָסעם	על־אַפּם ועל־חמתם
אַלאָפֿים	אַלפֿים
אַל דאַאַטייפֿט אַטפֿוך	על דאַטפֿתּ אַטפֿוך
אַלדאַאַס־	על־דעת־
אַלדאַאַס־אַצמע	על־דעת־עצמו
אַל־דאַאַס־אַצמע	על־דעת־עצמו
אַל־האַטוירע וועאַל־האָאַוווידע	על־התּורה ועל־העבֿודה
אַל־האָייצים וועאַל־האָאַוואָנים	על־העצים ועל־האַבֿנים
אַל־האָייצים וועאַל־האַבייצים	על־העצים ועל־הביצים
אַל־האַניסים	על־הנסים
אַל־האַשעם וועאַל־מעשיכע	על־ה׳ ועל־משיחו
אַלופֿים	אַלופֿים
אַל טאַשליכיינו לעייס־זיקנע	אַל תּשליכנו לעת־זיקנה
אַל טיסטאַקל בעקאַנקן	אַל תּסתּכּל בקנקן
אַל טיפֿטאַך פּע לאַסאָטן	אַל תּפֿתּח פּה לשׂטן
אַלטנײַ	על־תּנאַי
אַל־טנײַ	על־תּנאַי
אָלײַ וועאַל צאַוואָרי	עלי ועל צוואָרי
אַלייכעם־וועאַל־בנייכעם	עליכם־ועל־בניכם
אַלייכעם־שאָלעם	עליכם־שלום
אָליינו	עלינו
אַלייעם־האַשאָלעם	עליהם־השלום
אַלילעס־דאַם	עלילת־דם
אַלילעס־שאָוו	עלילת־שוא
אַליִע	עליה
אַליִעס	עליות
אַליִעס־נעשאָמע	עלית־נשמה
אַל־כעזשבוינע	על־חשבונו
אַל־כעזשבם	על־חשבון
אַל־כעזשבן	על־חשבון
אַלכעט	על־חטא
אַלכעט שעכאָטאָסי	על־חטא שחטאָתי
אָל־מאַלכעס־שאָמאַיִם	עול־מלכות־שמים
אַלמאָנע	אַלמנה
אַלמע־דיקשויט	עלמא־דקשוט
אַלמען	אַלמן
אַל־מענאַס לעהאַכזער	על־מנת להחזיר
אַל־מענאַס לעקאַבל פּראַס	על־מנת לקבל פּרס
אַל־מענאַס שעלוי לעקאַבל פּראַס	על־מנת שלא לקבל פּרס
אָלעהאַשאָלעם	עליה־השלום
אָלעוואַשאָלעם	עליו־השלום
אָלעוו־האַשנאָבל	עליו־השנאָבל
אַלעווײַ	הלוואַי
אָלעל	עלול
אַלעמײַ	אַלמאַי
אַלעף	א
אַלעף	אַלוף
אַלעף	אַלף
אַלעפֿבייס	אַלף־בית
אַלעקסאַנדער	אַלכּסנדר
אַלעקסאַנדערס	אַלכּסנדרס
אַלעקסאַנדערן	אַלכּסנדרן
אַלעקסאַנדער מאָקדן	אַלכּסנדר מוקדון
אָלעשאָלעם	עליה־השלום
אַל־פּאָראָשעס־דראָכים	על־פּרשת־דרכים
אָל־פּאַרנאָסע	עול־פּרנסה
אַלפּי	על־פּי
אַלפּי־גוירל	על־פּי־גורל
אַלפּי־דין	על־פּי־דין
אַלפּי־דינייהעם	על־פּי־דיניהם
אַלפּי־דערעך־האַטעווע	על־פּי־דרך־הטבֿע
אַלפּי־האַטכאַק	על־פּי־הדחק
אַלפּי־טאָעס	על־פּי־טעות
אַלפּי־יוישער	על־פּי־יושר
אַלפּי־כקירע	על־פּי־חקירה
אַלפּי־מיקרע	על־פּי־מיקרה
אַלפּי־נעס	על־פּי־נס
אַלפּי־סוואָרע	על־פּי־סבֿרה
אַלפּי־סייכל	על־פּי־שׂכל
אַלפּי־פּשאַט	על־פּי־פּשט
אַלפּי־ראָוו	על־פּי־רובֿ
אַלפּי־רעמעז	על־פּי־רמז
אַל־פּי	על־פּי
אַל־פּי־גוירל	על־פּי־גורל
אַל־פּי־דין	על־פּי־דין
אַל־פּי־דינייהעם	על־פּי־דיניהם
אַל־פּי־דערעך־האַטעווע	על־פּי־דרך־הטבֿע
אַל־פּי־האַטכאַק	על־פּי־הדחק
אַל־פּי־טאָעס	על־פּי־טעות
אַל־פּי־יוישער	על־פּי־יושר
אַל־פּי־כקירע	על־פּי־חקירה
אַל־פּי־מיקרע	על־פּי־מיקרה
אַל־פּי־נעס	על־פּי־נס
אַל־פּי־סוואָרע	על־פּי־סבֿרה
אַל־פּי־סייכל	על־פּי־שׂכל
אַל־פּי־פּשאַט	על־פּי־פּשט
אַל־פּי־ראָוו	על־פּי־רובֿ
אַל־פּי־רעמעז	על־פּי־רמז
אַל־פּע	על־פּה
אַלפֿיי־אַלאָפֿים	אַלפֿי־אַלפֿים
אַלצאַד־האַיויסערטאָוו	על־צד־היותר־טובֿ
אַלקאָלפּאָנעם	על־כּל־פּנים
אַל קאָל צאָרע שעלוי־סאָוווי	על כּל צרה שלא־תבֿוא
אַלקידעש־האַשעם	על־קידוש־השם
אַלקיין	על־כּן
אַלקלפּאָנעם	על־כּל־פּנים
אַלקן	על־כּן
אַל־קערן־האַצווי	על־קרן־הצבֿי
אַל רישן רישן וועאַל אַכרען אַכרען	על ראשון ראשון ועל אַחרון אַחרון
אַל־רעגל־אַכעס	על־רגל־אַחת
אַם	עם
אַמאָלייקים	עמלקים
אַמאָלעק	עמלק
אָמאַר	אָמר
אַמאָרעץ	עם־האָרץ
אַמאָרעץ־דעוירײַסאָ	עם־האָרץ־דאורײַתא
אַם־האַסייפֿער	עם־הספֿר
אַמודים	עמודים
אַמוין	עמון
אַמויראָיִם	אַמוראָים
אַמוירע	אַמורא
אָמיין	אָמן
אָמיין־סעלאָ	אָמן־סלה
אָמיין פֿכיין יעהי ראָצן	אָמן וכן יהי רצון
אַם ייִסראָעל כײַ	עם ישׂראל חי
אַמכאָ	עמך
אַם־כאָכעם־ווענאָוון	עם־חכם־ונבֿון
אַמנען	אַמנון
אָמעד	עמוד
אַמעד־אָנען	עמוד־ענן
אַמעד־האַטאָוועך	עמוד־התּווך
אַמעד־האָייש	עמוד־האש
אַמעד־העאָנען	עמוד־הענן
אַמעדייש	עמוד־אש
אָמעס	עמוס
אָמעסן	עמוסן
אָמעסעס	עמוסעס
אַמע־פּעזיזע	עמא־פּזיזא
אָמעק	עמוק
אַמעראַצים	עם־האָרץ
אַמעראַציש	עם־הארציש
אַמעראַצעס	עם־הארצות
אַמקאָנים	עמקנים
אַמקן	עמקן
אַמקעס	עמקות
אַם־קשיי־אוירעף	עם־קשה־עורף
אַנאָווים	ענווים
אַנאָווע	ענווה
אַנאָשים	אַנשים
אָנאָשים	עונשים
אַנאָשים־כשוּווים	אַנשים־חשובֿים
אַנאָשים־כאַשוּווים	אַנשים־חשובֿים
אַנאָשים נאָשים וועטאַף	אַנשים נשים וטף
אַנדרויגינעס	אַנדרוגינוס
אָנויכי	אָנוכי
אַנוסים	אַנוסים
אַנטיִאָכעס	אַנטיוכוס
אַנטיִאָכעס האַראָשע	אַנטיוכוס הרשע
אָני	עני
אָני־באַפּעסעך	עני־בפּתח
אָני־האָגן	עני־הגון
אַני־האַקאָטן	אַני־הקטן
אַניוועס	עניוות
אָני־וועעוויען	עני־ואבֿיון
אַניִיִם	עניים
אַניִיִם־האַגונים	עניים־הגונים
אַניִיִם־וועעוויוינים	עניים־ואבֿיונים
אַניִיִם־מעדוקאָיִם	עניים־מדוכּאָים
אַני־מײַמען	אַני־מאמין
אָני־מעדוקע	עני־מדוכּא
אַניִעס	עניות
אַני שלוימע	אַני שלמה
אָני־שעבאַאַניִיִם	עני־שבעניים
אָנכאַזערן	אָנחזירן
אָנכידעשן	אָנחידושן
אָנעוו	ענוו
אָנעס	אָנוס
אָנשיקערן	אָנשיכּורן
אַנשע	אַנשי־
אַנשע־מײַסע	אַנשי־מעשׂה
אַנשע־קנעסעס־האַגדוילע	אַנשי־כּנסת־הגדולה
אַנשע־שלוימיינו	אַנשי־שלומנו
אָס	אות
אַסאָקים	עסקים
אַסאָרע־בעטייוועס	עשׂרה־בטבֿת
אַסאָרע־האַרוגע־מאַלכעס	עשׂרה־הרוגי־מלכות
אַסאָרע־רישוינים	עשׂרה־ראשונים
אָס־בעאָס	אות־באות
אַסוסע	אַסותא
אַסורים	אַסורים
אַסורע	אַסורה
אַסיפֿע	אַסיפֿה
אַסכאַלטע־דעגעולע	אַתחלתּא־דגאולה
אַסמאַכטע	אַסמכתּא
אַסנע	אַסנה
אָסעד	עתיד
אָסעד ליטויל עס האַדין	עתיד לטול את הדין
אָסער	אָסור
אָסער־כאַזער	אָסור־חזיר
אָסער־לעדאַבער	אָסור־לדבר
אָסער־לעראַכעם	אָסור־לרחם
אַסערן	אַסרן
אַסערעס־בניי־האָמען	עשׂרת־בני־המן
אַסערעס־האַדיברעס	עשׂרת־הדיברות
אַסערעס־האַשוואָטים	עשׂרת־השבֿטים
אַסערעס־יעמיי־טשוּווע	עשׂרת־ימי־תּשובֿה
אַסקאָנים	עסקנים
אָסקים־בעמיצוועס	עוסקים־במיצוות
אָסקים־בעצאָרכע־ציבער	עוסקים־בצרכי־ציבור
אַסקן	עסקן
אַסקערע	אַסכּרה
אָף	עוף
אָפּגעכוימערט	אָפּגעחומרט
אַפּויטיקע	אַפּותּיקא
אַפּויטיקע	אַפּותּיקי
אַפּיקאָרסים	אַפּיקורסים
אַפּיקאָרסיש	אַפּיקורסיש
אַפּיקאָרסישער	אַפּיקורסישער
אַפּיקאָרסישע	אַפּיקורסישע
אַפּיקאָרסישן	אַפּיקורסישן
אַפּיקאָרסעס	אַפּיקורסות
אַפּיקוירעס	אַפּיקורס
אַפּיקוירעסטע	אַפּיקורסטע
אָפּכוירעשן	אָפּחורשן
אָפּכוישעכן	אָפּחושכן
אָפּכײַען	אָפּחיען
אָפּמאָשלען	אָפּמשלען
אַפּעטראָפּסים	אַפּוטרופּוסים
אַפּעטראָפּסים	אַפּוטרופּסים
אַפּעטראָפּסעס	אַפּוטרופּסות
אַפּעטראָפּעס	אַפּוטרופּוס
אַפּעטראָפּעס	אַפּוטרופּס
אַראָפּפּאַטערן	אַראָפּפּטרן
אַראָפּגעפּאַטערט	אַראָפּגעפּטרט
אָפּפּאַטערן	אָפּפּטרן
אַפּשיטע	אַפּשיטא
אַפֿילע	אַפֿילו
אַפֿיקוימען	אַפֿיקומן
אָפֿער־וואָייפֿער	עפֿר־ואפֿר
אַפֿרע־דעאַרע	עפֿרא־דאַרעא
אַצאָמעס	עצמות
אַצאָמעס־האַיעוויישעס	עצמות־היבֿשות
אַצאָסי	עצתי
אַצוועס	עצבֿות
אַצוועסניצע	עצבֿותניצע
אַצוועסניק	עצבֿותניק
אַצילעס	אַצילות
אַצירעס	עצירות
אָץ־קויצעץ	אָץ־קוצץ
אַקאָרים	עקרים
אַקאָרע	עקרה
אַקאָרעס	עקרות
אַקדאָמעס	אַקדמות
אַקודים נעקודים אוּוורודים	עקודים נקודים ובֿרודים
אַקום	עכּו״ם
אָקיאָנעס	אוקינוס
אַקיווע	עקיבֿא
אַקיוועס	עקיבֿאס
אַקיווען	עקיבֿאן
אַקיידע	עקדה
אַקיידעס־ייִצכאָק	עקדת־יצחק
אָקער	עקר
אַקערעס־האַבאַיִס	עקרת־הבית
אַקרעוו	עקרבֿ
אַקרען	עקרען
אַקשאָנים	עקשנים
אַקשאָנעס	עקשנות
אַקשן	עקשן
אַקשנטע	עקשנטע
אַקשענען	עקשנען
אַראָווע	ערבֿה
אַראָכין	ערכין
אַראַם	אַרם
אַראַמי	אַרמי
אַראַמיש	אַרמיש
אַראַם־נאַהאַראַיִם	אַרם־נהרים
אַראָראַט	אַררט
אַרבאָיִם	אַרבעים
אַרבאָע־באָנים	אַרבעה־בנים
אַרבאָע־טורים	אַרבעה־טורים
אַרבע	אַרבה
אַרבע־מיסעס־בעזדן	אַרבע־מיתות־בית־דין
אַרבע־מיסעס־בעזן	אַרבע־מיתות־בית־דין
אַרבע־פּינעס־האָוילעם	אַרבע־פּינות־העולם
אַרבעקאַנפֿעס	אַרבע־כּנפֿות
אַרבעקאַנפֿעסל	אַרבע־כּנפֿותל
אַרבע־קויסעס	אַרבע־כּוסות
אַרבע־רוכעס	אַרבע־רוחות
אַרבע־רוכעס־האָוילעם	אַרבע־רוחות־העולם
אַרוגע	ערוגה
אָרווים	ערבֿים
אָרוועס	ערבֿות
אַרוינעס	אַרונות
אַרויסמעשאַלייעכן	אַרויסמשלחן
אַרויסגעמעשאַלייעכט	אַרויסגעמשלחט
אַרויספּאַטערן	אַרויספּטרן
אַרויסגאַנווענען	אַרויסגנבֿענען
אַרויסגעגאַנוועט	אַרויסגעגנבֿעט
אַרויעס	עריות
אַרורים	אַרורים
אַרורע	אַרורה
אַרי	אַר״י
אַריבערגאַנווענען	אַריבערגנבֿענען
אַריבערצוגאַנווענען	אַריבערצוגנבֿענען
אַריבערגעגאַנוועט	אַריבערגעגנבֿעט
אַרייווים	ערבֿים
אַרייוועס	ערבֿות
אַריילים	ערלים
אַריילעס	ערלית
אַרײַנגאַנווענען	אַרײַנגנבֿענען
אַרײַנצוגאַנווענען	אַרײַנצוגנבֿענען
אַרײַנגעגאַנוועט	אַרײַנגעגנבֿעט
אַרײַניאַשווען	אַרײַנישבֿען
אַרײַניאַשווענען	אַרײַנישבֿענען
אַרײַעס	עריות
אַריכעס־יאָמים	אַריכות־ימים
אַריע	אַריה
אַריעס	אַריהס
אַריען	אַריהן
אַרי־שעבאַכאַוווּרע	אַרי־שבחבֿורה
אָרכים	אורחים
אָרכים־האַגונים	אורחים־הגונים
אָרכעפּאָרכע	אָרחי־פּרחי
אָרל	ערל
אָרלטע	ערלטע
אָרלע	ערלה
אָרמע	ערמה
אַרן	אַהרן
אַרנס	אַהרנס
אָרן	אָרון
אַרן האַקויען	אַהרן הכּהן
אָרנקוידעש	אָרון־קודש
אָרעוו	ערובֿ
אָרעוו	ערבֿ
אָרעווטע	ערבֿטע
אָרעווניצע	ערבֿניצע
אָרעווניק	ערבֿניק
אָרעוו־קאַבלען	ערבֿ־קבלן
אָרעם־באָכער	אָרעם־בחור
אָרע־מיקלעט	ערי־מיקלט
אָרער	אָרור
אָרצע	אָרצה
אָשאַמנו	אָשמנו
אָשאַמנו באָגאַדנו גאָזאַלנו	אָשמנו בגדנו גזלנו
אַשור	אַשור
אַשירים	עשירים
אַשירעס	עשירות
אַשמוירע	אַשמורה
אַשמעדײַ	אַשמדאַי
אָשער	אָשר
אָשערס	אָשרס
אָשערן	אָשרן
אָשער	עשיר
אַשער־יאָצער	אַשר־יצר
אַשער־יאָצערל	אַשר־יצרל
אַשעריאָצער־פּאַפּיר	אַשר־יצר־פּאַפּיר
אַשער לוי …ו אַווויסיינו	אַשר לא …ו אַבֿותנו
אַשפּע	אַשפּה
אַשקענאַז	אַשכּנז
אַשקענאַזים	אַשכּנזים
אַשקענאַזי	אַשכּנזי
האַוואָרע־אַשקענאַזיס	הבֿרה־אַשכּנזית
אַשקענאַזיש	אַשכּנזיש
אַשקענאַזער	אַשכּנזער
אַשריי	אַשרי
אַשריי האַמײַמען	אַשרי המאמין
באַ…	ב…
באַאַוולען	באַעוולען
באַאַכילע	באַכילה
באַאַל	בעל
באַאַלי	בעלי
באַאַלע	בעלה
באַאַמידע	בעמידה
באָבע־מײַסע	בבֿא־מעשׂה
באָגאַדנו	בגדנו
באָגדים	בוגדים
באָגרים	בוגרים
באָגרעס	בוגרת
באַדאַמען	באַדמען
באַדכאָנים	בדחנים
באַדכאָניש	בדחניש
באַדכאָנעס	בדחנות
באַדכן	בדחן
באַדכענען	בדחנען
באָדעק־אומענוסע	בדוק־ומנוסה
באַוווינעסיינו־האָראַבים	בעוונותינו־הרבים
באָוול	בבֿל
באַוולי	בבֿלי
באָוול־סכוירע	בבֿל־סחורה
באָוול־קוינים	בבֿל־קונים
באָוול־קוינע	בבֿל־קונה
באָווע־באַסרע	בבֿא־בתרא
באָווע־מײַסע	בבֿא־מעשׂה
באָווע־מעציִע	בבֿא־מציעא
באָווע־קאַמע	בבֿא־קמא
באָו מאַיִם אַד נעפֿעש	באָו מים עד נפֿש
באָזנײַ שאָמאַטי	באָזני שמעתּי
באָזע	בזוי
באַזע אוּוואַוואָ	בזה ובֿבֿאָ
באַטאַמט	באַטעמט
באַטים	בתּים
באַטכאָנים	בדחנים
באַטכאָניש	בדחניש
באַטכאָנעס	בדחנות
באַטכן	בדחן
באַטכענען	בדחנען
באָטל	בטל
באָטל־אומוווּטל	בטל־ומבֿוטל
באַטלאָנים	בטלנים
באַטלאָניש	בטלניש
באַטלאָנעס	בטלנות
באָטל־בעשישים	בטל־בשישים
באַטלען	בטלן
באַטלען	בטלען
באַטלענען	בטלענען
באַטל	בטל
באַטלסט	בטלסט
באַטלט	בטלט
באָטע	בתּי־
באָטע־יעסוימים	בתּי־יתומים
באָטע־מידראָשים	בתּי־מדרשים
באָטע־קנעסעס	בתּי־הכּנסת
באַטקען	בדקען
באַטקענען	בדקענען
באַיאָמים־האָהיים	בימים־ההם
באַיִס־רישן	בית־ראשון
באַיִס־שייני	בית־שני
באַכורים	בחורים
באַכיינט	באַחנט
באָכער	בחור
באָכערווײַז	בחורווײַז
באָכערל	בחורל
באָכערס	בחורס
באָכער־האַזעצער	בחור־הזעצער
באָכערטע	בחורטע
באָכערים	בחורים
באָכערימלעך	בחורימלעך
באָכערעץ	בחורעץ
באַל	בעל־
באַלאַוויירע	בעל־עבֿירה
באַלאַוויירעניצע	בעל־עבֿירהניצע
באַלאַוויירעניק	בעל־עבֿירהניק
באַלאַוולע	בעל־עוולה
באַלאַכסאַניע	בעל־אַכסניא
באַלאַכסן	באַלכסון
באַלאַכרײַעס	בעל־אַחריות
באַלאָנים	בעלנים
באַלאָנעס	בעלנות
באַלאַסקן	בעל־עסקן
באַלבאָסער	בעל־בשׂר
באַלביטאָכן	בעל־בטחון
באַלבעטועך	בעל־בטוח
באַלבעכי	בעל־בכי
באַלבריס	בעל־ברית
באַלגוזמע 	בעל־גוזמא
באַלגוף	בעל־גוף
באַלגײַווע	בעל־גאווה
באַלגײַוועטע	בעל־גאווהטע
באַלגײַוועניצע	בעל־גאווהניצע
באַלגײַוועניק	בעל־גאווהניק
באַל־דאַבראָנים	בעל־דברנים
באַלדאַברען	בעל־דברן
באַלדאָווער	בעל־דבֿר
באַל־דאַרשאָנים	בעל־דרשנים
באַלדאַרשן	בעל־דרשן
באַלדאַרשער	בעל־דרשער
באַלדייע	בעל־דעה
באַל־דימיוינעס	בעל־דמיונות
באַלדימיען	בעל־דמיון
באַלדין	בעל־דין
באַלדיקדעק	בעל־דיקדוק
באַל־דערעכערעץ	בעל־דרך־ארץ
באַלהאָזע	בעל־העזה
באַלהאַטורים	בעל־הטורים
באַלהאַכנאָסע	בעל־הכנסה
באַל־האַכנאָסעס־אָרכים	בעל־הכנסת־אורחים
באַלהאַלוואָע	בעל־הלוואה
באַלהאַמצאָע	בעל־המצאה
באַל־האַנעס	בעל־הנס
באַלהאַשפּאָע	בעל־השפּעה
באַלהויצאָע	בעל־הוצאה
באַלזיקאָרן	בעל־זכּרון
באַלטאַכבולע	בעל־תּחבולה
באַלטאַכלעס	בעל־תּכלית
באַלטאַכלעסניצע	בעל־תּכליתניצע
באַל־טאַקיפֿים	בעל־תּקיפֿים
באַלטאַקסע	בעל־טאַקסע
באַלטאַקעף	בעל־תּקיף
באַל־טאַשכיס	בל־תּשחית
באַלטוויִע	בעל־תּבֿיעה
באַלטויווע	בעל־טובֿה
באַלטויוועניצע	בעל־טובֿהניצע
באַלטײַווע	בעל־תּאווה
באַלטײַוועניצע	בעל־תּאווהניצע
באַלטײַוועניק	בעל־תּאווהניק
באַלטײַנע	בעל־טענה
באַלטענאַך	בעל־תּנך
באַלטעקייע	בעל־תּוקע
באַלטפֿילע	בעל־תּפֿילה
באַל־טפֿילעס	בעל־תּפֿילות
באַלטקיִע	בעל־תּקיעה
באַל־טקיִעס	בעל־תּקיעות
באַל־טקיפֿים	בעל־תּקיפֿים
באַלטשוּווע 	בעל־תּשובֿה
באַל־טשוּווע	בעל־תּשובֿה
באַלטשוּוועטע	בעל־תּשובֿהטע
באַלטשוּוועניצע	בעל־תּשובֿהניצע
באַלטשוּוועניק	בעל־תּשובֿהניק
באַל־טשוּוועס	בעל־תּשובֿות
באַליוורע	בעל־עבֿרי
באַליויוול	בעל־יובֿל
באַליויוולטע	בעל־יובֿלטע
באַליויעץ	בעל־יועץ
באַליויעצטע	בעל־יועצטע
באַלייִכעס	בעל־ייִחוס
באַלייִכעסטע	בעל־ייִחוסטע
באַלייסעק	בעל־עסק
באַלייִעש	בעל־ייִאוש
באַלייצע	בעל־עצה
באַליעכוילעס	בעל־יכולת
באַליעסורים	בעל־יסורים
באַלכאַלוימעס	בעל־חלומות
באַלכאַסענע	בעל־חתונה
באַלכויוו	בעל־חובֿ
באַלכײַ	בעל־חי
באַלכײַעוו	בעל־חייבֿ
באַלכעזשבם	בעל־חשבון
באַלכעסעד	בעל־חסד
באַל־לאָשן	בעל־לשון
באַל־לאָשנקוידעש	בעל־לשון־קודש
באַלמאַגיִע	בעל־מגיה
באַלמאַזל	בעל־מזל
באַלמאַכלויקעס	בעל־מחלוקת
באַלמאַכשאָוועס	בעל־מחשבֿות
באַלמאַפֿטער	בעל־מפֿטיר
באַלמאַצליִעך	בעל־מצליח
באַל־מאָרעשכוירע	בעל־מרה־שחורה
באַלמאַשכיס	בעל־משחית
באַלמויעך	בעל־מוח
באַלמויפֿעס	בעל־מופֿת
באַלמום 	בעל־מום
באַלמוסעף	בעל־מוסף
באַלמוסער	בעל־מוסר
באַלמוצלעך	בעל־מוצלח
באַלמידע	בעל־מידה
באַלמידעס	בעל־מידות
באַלמייכעש	בעל־מיחוש
באַלמיכיע	בעל־מחיה
באַלמילכאָמע	בעל־מלחמה
באַלמיצווע	בעל־מיצווה
באַלמישפּאָכע	בעל־משפּחה
באַלמישפּעט	בעל־מישפּט
באַלמעגאַזעם	בעל־מגזם
באַלמעגאַזעמטע	בעל־מגזמטע
באַלמעדאַקדעק	בעל־מדקדק
באַלמעזעקטאָוו	בעל־מזג־טובֿ
באַל־מעטופּאָלים	בעל־מטופּלים
באַלמעטופּל	בעל־מטופּל
באַלמעכאַבער	בעל־מחבר
באַלמעכאַשעף	בעל־מכשף
באַלמעלאָכע	בעל־מלאָכה
באַלמעלאָכעס	בעל־מלאָכות
באַלמעלאָכעס	בעל־מלאָכהס
באַלמעליצע	בעל־מליצה
באַלמענאַגן	בעל־מנגן
באַלמעפֿאַרנעס	בעל־מפֿרנס
באַלמעפֿוניצע	בעל־מפֿוניצע
באַלמעפֿונעק	בעל־מפֿונק
באַלמעציִעס	בעל־מציאות
באַלמעקאַנע	בעל־מקנא
באַלמעקובל	בעל־מקובל
באַלן	בעלן
באַלנטע	בעלנטע
באַלנילע	בעל־נעילה
באַלניסויען	בעל־נסיון
באַלניצאָכן	בעל־נצחון
באַלנעס	בעל־נס
באַל־נעס	בעל־נס
באַלסאָד	בעל־סוד
באַלסייכל	בעל־שׂכל
באַלסייכלטע	בעל־שׂכלטע
באַלסימכע	בעל־שׂימחה
באַלסימכעטע	בעל־שׂימחהטע
באַלסימכעניצע	בעל־שׂימחהניצע
באַלע	בעלי־
באַלע־אַוויירעס	בעלי־עבֿירות
באַלע־אַוולעס	בעלי־עוולות
באַלע־איוורע	בעלי־עבֿרי
באַלע־אייצעס	בעלי־עצות
באַלע־אַכסאַניעס	בעלי־אַכסניות
באַלע־אַכרײַעס	בעלי־אַחריות
באַלע־אַסאָקים	בעלי־עסקים
באַלע־אַסקאָנים	בעלי־עסקנים
באַלעבאַטים	בעלי־בתּים
באַלעבאַטיש	בעל־הבתּיש
באַלעבאַטישער	בעל־הבתּישער
באַלעבאַטישע	בעל־הבתּישע
באַלעבאַטישן	בעל־הבתּישן
באַלעבאַטישקייט	בעל־הבתּישקייט
באַלעבאַטעווען	בעל־הבתּעווען
באַלעבאָס	בעל־הבית
באַלעבאָסטע	בעל־הביתטע
באַלעבאָסטעס	בעל־הביתטעס
באַלע־באָסערס	בעלי־בשׂרס
באַלע־ביטאָכן	בעלי־בטחון
באַלע־בעטוכים	בעלי־בטוחים
באַלע־בעכי	בעלי־בכי
באַלעבעסל	בעל־הביתל
באַלע־בריסן	בעלי־בריתן
באַלעגאָלע	בעל־עגלה
באַלע־גוזמאָעס	בעלי־גוזמאָות
באַלע־גוזמע	בעלי־גוזמא
באַלע־גוזמעס	בעלי־גוזמות
באַלעגוף	בעל־הגוף
באַלע־גופֿים	בעלי־גופֿים
באַלע־גײַוועס	בעלי־גאוות
באַלע־דאַבראָנים	בעלי־דברנים
באַלע־דאָווער	בעלי־דבֿר
באַלע־דאַרשאָנים	בעלי־דרשנים
באַלע־דייעס	בעלי־דעות
באַלע־דימיוינעס	בעלי־דמיונות
באַלע־דינים	בעלי־דינים
באַלע־דיקדעק	בעלי־דיקדוק
באַלע־דערעכערעץ	בעלי־דרך־ארץ
באַלע־האַכנאָסע	בעלי־הכנסה
באַלע־האַכנאָסעס־אָרכים	בעלי־הכנסת־אורחים
באַלע־האַלוואָעס	בעלי־הלוואָות
באַלע־האַמצאָעס	בעלי־המצאָות
באַלע־האַשפּאָע	בעלי־השפּעה
באַלע־הויצאָעס	בעלי־הוצאָות
באַלע־זיקאָרן	בעלי־זכּרון
באַלע־טאַכבולעס	בעלי־תּחבולות
באַלע־טאַכלייסים	בעלי־תּכליתים
באַלע־טאַכלעס	בעלי־תּכלית
באַלע־טאַקיפֿים	בעלי־תּקיפֿים
באַלע־טאַקסעס	בעלי־טאַקסעס
באַלע־טוויִעס	בעלי־תּבֿיעות
באַלע־טויוועס	בעלי־טובֿות
באַלע־טויסעפֿעס	בעלי־תּוספֿות
באַלע־טײַוועס	בעלי־תּאוות
באַלע־טײַנעס	בעלי־טענות
באַלע־טענאַך	בעלי־תּנך
באַלע־טפֿילעס	בעלי־תּפֿילות
באַלע־טקיִעס	בעלי־תּקיעות
באַלע־טקיפֿים	בעלי־תּקיפֿים
באַלע־טשוּווע	בעלי־תּשובֿה
באַלע־טשוּוועס	בעלי־תּשובֿות
באַלע־יויוולס	בעלי־יובֿלס
באַלע־יויעצים	בעלי־יועצם
באַלע־ייִכוסים	בעלי־ייִחוסים
באַלע־ייִכעס	בעלי־ייִחוס
באַלע־ייִעש	בעלי־ייִאוש
באַלע־יעכוילעס	בעלי־יכולת
באַלע־יעסורים	בעלי־יסורים
באַלע־כאַיאָווים	בעלי־חייבֿים
באַלע־כאַיִם	בעלי־חיים
באַלע־כאַלוימעס	בעלי־חלומות
באַלע־כאַסענע	בעלי־חתונה
באַלע־כויוועס	בעלי־חובֿות
באַלע־כסאָדים	בעלי־חסדים
באַלע־כעזשבוינעס	בעלי־חשבונות
באַלע־לאָשנקוידעש	בעלי־לשון־קודש
באַלע־לעשוינעס	בעלי־לשונות
באַלע־מאַזאָלעס	בעלי־מזלות
באַלע־מאַכלויקעס	בעלי־מחלוקת
באַלע־מאַכלויקעסן	בעלי־מחלוקתן
באַלע־מאַכשאָוועס	בעלי־מחשבֿות
באַלע־מאַפֿטער	בעלי־מפֿטיר
באַלע־מאָפֿסים	בעלי־מופֿתים
באַלע־מאַצליכים	בעלי־מצליחים
באַלע־מאָרעשכוירע	בעלי־מרה־שחורה
באַלע־מאַשכיסים	בעלי־משחיתים
באַלע־מויכעס	בעלי־מוחות
באַלע־מויעך	בעלי־מוח
באַלע־מום	בעלי־מום
באַלע־מומים	בעלי־מומים
באַלע־מוסעף	בעלי־מוסף
באַלע־מוסער	בעלי־מוסר
באַלע־מידעס	בעלי־מידות
באַלע־מייכושים	בעלי־מיחושים
באַלע־מייכעשן	בעלי־מיחושן
באַלע־מיכיעס	בעלי־מחיות
באַלע־מילכאָמעס	בעלי־מלחמות
באַלע־מעלאָכעס	בעלי־מלאָכות
באַלע־מיצוועס	בעלי־מיצוות
באַלע־מישפּאָכעס	בעלי־משפּחות
באַלע־מישפּעט	בעלי־מישפּט
באַלע־מעדאַקדעקים	בעלי־מדקדקים
באַלע־מעזעקטאָוו	בעלי־מזג־טובֿ
באַלע־מעטופּאָלים	בעלי־מטופּלים
באַלע־מעכאַברים	בעלי־מחברים
באַלע־מעכאַשפֿים	בעלי־מכשפֿים
באַלע־מעליצעס	בעלי־מליצות
באַלע־מענאַגנים	בעלי־מנגנים
באַלע־מעפֿאַרנעסים	בעלי־מפֿרנסים
באַלע־מעציִעס	בעלי־מציאות
באַלע־מעקאַנים	בעלי־מקנאים
באַלע־מעקובאָלים	בעלי־מקובלים
באַלע־נילע	בעלי־נעילה
באַלע־ניסיוינעס	בעלי־נסיונות
באַלע־ניסים	בעלי־נסים
באַלע־ניצכוינעס	בעלי־נצחונות
באַלע־סוידעס	בעלי־סודות
באַלע־סייכל	בעלי־שׂכל
באַלע־סימכעס	בעלי־שׂימחות
באַלע־פּאַכדאָנים	בעלי־פּחדנים
באַלע־פּאַרנאָסע	בעלי־פּרנסה
באַלע־פּאַשראָנים	בעלי־פּשרנים
באַלע־פּויאַלים	בעלי־פּועלים
באַלע־פּיקדוינעס	בעלי־פּקדונות
באַלע־פּלייטעס	בעלי־פּליטות
באַלע־צדאָקע	בעלי־צדקה
באַלע־צדאָקעס	בעלי־צדקות
באַלע־צורעס	בעלי־צורות
באָלעק	בלק
באַלע־קאַבאָלע	בעלי־קבלה
באַלע־קויכעס	בעלי־כּוחות
באַלע־קויעך	בעלי־כּוח
באַלע־קיירע	בעלי־קרי
באַלע־קיסים	בעלי־כּיסים
באַלע־קישרוינעס	בעלי־כּישרונות
באַלע־קריִע	בעלי־קריאה
באַלע־ראַכמאָנים	בעלי־רחמנים
באַלע־ראַכמאָנעס	בעלי־רחמנות
באַלע־ראַכמים	בעלי־רחמים
באַלע־שאַכרייסים	בעלי־שחריתים
באַלע־שאַכרעס	בעלי־שחרית
באַלע־שיימעס	בעלי־שמות
באַלע־שעם	בעלי־שם
באַלע־שעפֿע	בעלי־שפֿע
באַלפּאַכדן	בעל־פּחדן
באַלפּאַרנאָסע	בעל־פּרנסה
באַלפּאַשרען	בעל־פּשרן
באַלפּויעל	בעל־פּועל
באַלפּיקאָדן	בעל־פּקדון
באַלפּלייטע	בעל־פּליטה
באַלפּע	בעל־פּה
באַלצדאָקע	בעל־צדקה
באַלצדאָקעטע	בעל־צדקהטע
באַל־צדאָקעס	בעל־צדקות
באַלצורע	בעל־צורה
באַל־צורעס	בעל־צורות
באַלקאַבאָלע	בעל־קבלה
באַלקאָרכאָך	בעל־כּרחך
באַלקאָרכע	בעל־כּרחה
באַלקאָרכע	בעל־כּרחו
באַלקאָרכעכאָ	בעל־כּרחך
באַלקאָרכעכאָ אַטאָ כײַ	בעל־כּרחך אַתּה חי
באַלקויעך	בעל־כּוח
באַלקוירע	בעל־קורא
באַלקײַסן	בעל־כּעסן
באַלקײַסנטע	בעל־כּעסנטע
באַלקיירע	בעל־קרי
באַלקיס	בעל־כּיס
באַלקישרען	בעל־כּישרון
באַלקערי	בעל־קרי
באַלקריִע	בעל־קריאה
באַלראַכמאָנעס	בעל־רחמנות
באַלראַכמים	בעל־רחמים
באַלראַכמען	בעל־רחמן
באַלשאַכרעס	בעל־שחרית
באַלשעם	בעל־שם
באַלשעמטאָוו	בעל־שם־טובֿ
באַלשעפֿע	בעל־שפֿע
באַמידבער	במדבר
באַמע דוואָרים אַמורים	במה דבֿרים אַמורים
באָנים	בנים
באָנים־זכאָרים	בנים־זכרים
באָנים־סכאָרים	בנים־זכרים
באַנשער	באשר
באַנשער־בעכיין	באשר־בכן
באַס	בת־
באַס־גיל	בת־גיל
באַס־האַיײַנע	בת־היענה
באַס־האָראַוו	בת־הרבֿ
באַס־האַשאָמאַיִם	בת־השמים
באַס־זקונים	בת־זקונים
באַס־טויווים	בת־טובֿים
באַס־טישים	בת־תּישעים
באַס־יײַנע	בת־יענה
באַס־ייִסראָעל	בת־ישׂראל
באַסיע	בתיה
באַסיעס	בתיהס
באַסיען	בתיהן
באַס־יעכידע	בת־יחידה
באַס־יעכיטקע	בת־יחידקע
באַסמאַלקע	בת־מלכּה
באַס־נײַמע	בת־נעמה
באַס־סקונים	בת־זקונים
באָסער	בשׂר
באָסער־וועדאָגים	בשׂר־ודגים
באָסערוועדאָם	בשׂר־ודם
באָסער קאָשער	בשׂר כּשר
באַס־ציִען	בת־ציון
באַס־קויען	בת־כּהן
באַס־שיווים	בת־שיבֿעים
באַס־שמוינים	בת־שמונים
באַסשעווע	בת־שבֿע
באַקאָשע	בקשה
באַקל־מיקל־קאָל	בכּל־מכּל־כּל
באָקע	בקי
באָקע בעכאָל־כעדרע־טוירע	בקי בכל־חדרי־תּורה
באָקע בעשעווע־כאָכמעס	בקי בשבֿע־חכמות
באָראָד	ברד
באַראָנשין	בר־עונשין
באַרבעראַוו	בר־בי־רבֿ
באַרדאַאַס	בר־דעת
באַרוריען	בר־אורין
באַריכעס	באַריכות
באָרכאַבע	ברוך־הבא
באָרכאַשעם	ברוך־השם
באָרכו	ברוך־הוא
באָרכו	ברכו
באָרכים	בורחים
באָרכי נאַפֿשי	ברכי נפֿשי
באַרכען	ברחען
באַרכענען	ברחענען
באַרמאַזל	בר־מזל
באַרמינאַן	בר־מינן
באַרמיצווע	בר־מיצווה
באַרמיצווע־באָכער	בר־מיצווה־בחור
באַרמיצוועס	בר־מיצוות
באַרמענען	בר־מינן
באַרנאַש	בר־נש
באַרסאַמכע	בר־סמכא
באָר־סוד	בור־סוד
באַרסייכל	בר־שׂכל
באָרע	ברי
באָרעך	ברוך
באָרעכס	ברוכס
באָרעכן	ברוכן
באָרעכאַבאָ	ברוך־הבא
באָרעכאַבע	ברוך־הבא
באָרעך־אַטאָ	ברוך־אַתּה
באָרעך־אַטע	ברוך־אַתּה
באָרעכאַשעם	ברוך־השם
באָרעך דײַען עמעס	ברוך דיין אמת
באָרעך דײַען האָעמעס	ברוך דיין האמת
באָרעך־האַנימצע	ברוך־הנימצא
באָרעך האַשעם יוים יוים	ברוך השם יום יום
באָרעך־הו	ברוך־הוא
באָרעך שעפּאָטראַני	ברוך שפּטרני
באָרע־לי	ברי־לי
באָרער	ברור
באָרערים	בוררים
באָרערעס	בוררות
באָרער־קאַשעמעש	ברור־כּשמש
באַרפּלוקטע	בר־פּלוגתּא
באַר־קאָכבע	בר־כּוכבא
באַר־קוזבע	בר־כּוזבא
באָשן	בשן
באַשער	באשר
באַשער־בעכיין	באשר־בכן
בגידע	בגידה
בגידע־בעמאַלכעס	בגידה־במלכות
בדיקע	בדיקה
בדיקעס־כאָמעץ	בדיקת־חמץ
בוי	בא
בויגעד	בוגד
בויגער	בוגר
בוידעק	בודק
בוידעק־כאָמעץ	בודק־חמץ
בויכער	בוחר
בוילעט	בולט
בויעז	בועז
בויעל	בועל
בויקייע־רעקיִיִם	בוקע־רקיעים
בוירייעך	בורח
בוירע	בורא
בוירע־אוילעם	בורא־עולם
בוירע־מעוירע־האָייש	בורא־מאורי־האש
בוירע־פּרי־האָאַדאָמע	בורא־פּרי־האַדמה
בוירע־פּרי־האַגאָפֿן	בורא־פּרי־הגפֿן
בוירער	בורר
בוישעס־פּאָנעם	בושת־פּנים
בוישעס־פּענעמער	בושת־פּנימער
בוּע	בועה
בור	בור
בור־דעוירײַסאָ	בור־דאורײַתא
בורים	בורים
בורים־דעוירײַסאָ	בור־דאורײַתא
בושע	בושה
בזויִם	בזויים
בי…	ב…
ביגדע־דאַלעס	בגדי־דלות
ביגדע־יאָנטעוו	בגדי־יום־טובֿ
ביגדע־מאַלכעס	בגדי־מלכות
ביגדע־מעשי	בגדי־משי
ביגדע־קעהונע	בגדי־כּהונה
ביגדע־שאַבעס	בגדי־שבת
ביגזיילע	בגזלה
ביגזיירעס	בגזרת־
ביגנייווע	בגנבֿה
בידמאָעס־שאָלעש	בדמעות־שליש
בידעלייקאָ	בדליכּאָ
ביִורים	ביאורים
ביזויען	בזיון
ביזיוינעס	בזיונות
ביזייר־אַנפּין	בזעיר־אַנפּין
ביזע־ביזויען	בזי־בזיון
ביזע־ביזיוינעס	בזי־בזיונות
ביטאָכן	בטחון
ביטכילע־אורכימע	בדחילו־ורחימו
ביטל	ביטול
ביטל־אייוואָרים	ביטול־אבֿרים
ביטל־אייוורים	ביטול־אבֿרים
ביטל־האַיעש	ביטול־היש
ביטל־טוירע	ביטול־תּורה
ביטמימעס	בתּמימות
ביטמיִע	בתּמיה
ביטנײַ	בתּנאַי
ביטשועס־כיין	בתּשואות־חן
בייז	ב
בייז	בית
ביין	בין
ביין אָדעם לאַמאָקעם	בין אָדם למקום
ביין אָדעם לעכאַוויירע	בין אָדם לחבֿרו
ביין־האַזמאַנים	בין־הזמנים
ביין־האַמצאָרים	בין־המצרים
ביין־האַשמאָשעס	בין־השמשות
ביין יעמינע אוסמוילע	בין ימינו ושׂמאלו
ביין יעמינע ליסמוילע	בין ימינו לשׂמאלו
ביין־מינכע־לעמײַרעוו	בין־מינחה־למעריבֿ
ביינע־לעביינע	בינו־לבינו
ביין־קעסע־לעאָסער	בין־כּסא־לעשׂור
בייס	ב
בייס	בית
בייס	בית־
בייס	בעת
בייס־האַכאַיִם	בית־החיים
בייס־האַמיגדעש	בית־המיקדש
בייס־האַמעדרעש	בית־המדרש
בייס־האַקאָוועד	בית־הכּבֿוד
בייס־האַקוואָרעס	בית־הקבֿרות
בייס־האַקיסע	בית־הכּיסא
בייס־האַקנעסעס	בית־הכּנסת
בייס־וואַאַד	בית־וועד
בייס־וואַאַד־לאַ…	בית־וועד־ל…
בייס־וואַאַד־לאַכאַכאָמים	בית־וועד־לחכמים
בייס־יאַנקעוו	בית־יעקבֿ
בייס־יאַנקעוו לעכו וועניילכאָ	בית־יעקבֿ לכו ונלכה
בייס־יעסוימים	בית־יתומים
בייס־לעכעם	בית־לחם
בייס־מײַסע	בעת־מעשׂה
בייצים	ביצים
בייצע	ביצה
בײַשאָנים	בײַשנים
בײַשאָנעס	בײַשנות
בײַשן	בײַשן
ביכדיי	בכדי
ביכוווידע־אוּוועאַצמע	בכבֿודה־ובֿעצמה
ביכוווידע־אוּוועאַצמע	בכבֿודו־ובֿעצמו
ביכוילעס	ביכולת
ביכידעס	ביחידות
ביכלאַל	בכלל
ביכשיוועס	בחשיבֿות
בילבולים	בילבולים
בילבל	בילבול
בילבל־דאַם	בילבול־דם
בילבל־האַמויכעס	בילבול־המוחות
בילהע	בלהה
בילו	ביל״ו
בילטי	בילתּי
בילטי־מעסופּעק	בילתּי־מסופּק
בילעם	בלעם
בימהיירע	במהרה
בימהיירע־בעיעמיינו	במהרה־בימינו
בימזומאָנים	במזומנים
בימזומען	במזומן
בימיי	בימי
בימכילע	במחילה
בימכילע־גמורע	במחילה־גמורה
בימנוכע	במנוחה
בימסוירע	במסורה
בימע	בימה
בימציִעס	במציאות
בימקעם	בימקום
בינאָריינו־אוּוויזקייניינו	בנערינו־ובֿזקנינו
ביניאָנים	בנינים
ביניען	בנין
בינלײַלע	בן־לילה
בינע	בינה
בינעם	בינם
בינעמס	בינמס
בינעמען	בינמען
בינקיטעס־כייפֿעץ	בנקיטת־חפֿץ
בינשימע־אַכעס	בנשימה־אַחת
בינשיקע	בנשיקה
ביסכוס	בזכות
ביסכוס־זע	בזכות־זה
ביִע	ביאה
ביִעס־האַגויעל	ביאת־הגואל
ביִער	ביאור
ביִער־כאָמעץ	ביעור־חמץ
ביִעש	ביוש
ביפֿכינעס	בבֿחינת
ביפֿניי־אַם־וועיידע	בפֿני־עם־ועדה
ביפֿניי־קאָאָל־וועיידע	בפֿני־קהל־ועדה
ביפֿניי־קאָל־אַם־וועיידע	בפֿני־כּל־עם־ועדה
ביפֿראַט	בפֿרט
אוביפֿראַט	ובפֿרט
ביפֿראָטיעס	בפֿרטיות
ביפֿרויטרעט	בפֿרוטרוט
ביקוויִעס	בקבֿיעות
ביקורים	ביכּורים
ביקלאַל	בכּלל
ביקסאַוו	בכּתבֿ
ביקער־כוילים	ביקור־חולים
בירמיזע	ברמיזה
בירקעס־האַמאָזן	ברכּת־המזון
בירקעס־קעהאַנים	ברכּת־כּהנים
בירשוס	ברשות־
בישגאָגע	בשגגה
בישטיקע	בשתּיקה
בישכיינעס	בשכנות
בישליימעס	בשלמות
בכאָר	בכור
בכאָרטע	בכורטע
בכוירים	בכורים
בכוירע	בכורה
בכוירעס	בכורות
בכינע	בחינה
בכיִע	בכיה
בכיִע־לעדוירעס	בכיה־לדורות
בכיר	בחיר
בכירע	בחירה
בלאַז	בלע״ז
בלי	בלי־
בלי־גוזמע	בלי־גוזמא
בלי־טנײַ	בלי־תּנאַי
בלי־יעפֿונע	בלי־יפֿונה
בלי־כאַראָטע	בלי־חרטה
בלי־מאַסקאָנע	בלי־מסקנא
בלי־ניידער	בלי־נדר
בלי־סאָפֿעק	בלי־ספֿק
בלי־קאַוואָנע	בלי־כּוונה
בלי־שום־טײַנע	בלי־שום־טענה
בלי־שום־סאָפֿעק	בלי־שום־ספֿק
בלעס־בריירע	בלית־ברירה
בנויס־גיל	בנות־גיל
בנויס־זקונים	בנות־זקונים
בנויס־יאַנקעוו	בנות־יעקבֿ
בנויס־ייִסראָעל	בנות־ישׂראל
בנויס־סקונים	בנות־זקונים
בנויס־ציִען	בנות־ציון
בנייאָדעם	בני־אָדם
בניי־אַניִיִם	בני־עניים
בנייאַרבאָיִם	בני־אַרבעים
בנייבאַיִס	בני־בית
בנייבריס	בני־ברית
בנייגיל	בני־גיל
בניידאַאַס	בני־דעת
בניידאָר	בני־דור
בנייהאָראַוו	בני־הרבֿ
בנייזוג	בני־זוג
בנייזקונים	בני־זקונים
בנייטויווים	בני־טובֿים
בנייטוירע	בני־תּורה
בנייטישים	בני־תּישעים
בניי־ייִסראָעל	בני־ישׂראל
בניי־יעכידים	בני־יחידים
בניי־מוישע	בני־משה
בניי־מעלאָכים	בני־מלכים
בניי־נויעך	בני־נח
בניי־נעוויִיִם	בני־נבֿיאים
בנייסקונים	בני־זקונים
בניי־קאַיאָמע	בני־קימא
בניי־ראַכמאָנים	בני־רחמנים
בניישיווים	בני־שיבֿעים
בניישישים	בני־שישים
בניישמוינים	בני־שמונים
בנעיאָדעם	בני־אָדם
בנעיִר	בן־עיר
בסאָמים	בשׂמים
בסאָמים־ביקס	בשׂמים־ביקס
בסורע־טויווע	בשׂורה־טובֿה
בסורע־ראָע	בשׂורה־רעה
בע…	ב…
בעאַהאַווע	באַהבֿה
בעאָזנײַ שאָמאַטי	באָזני שמעתּי
בעאַלמע	בעלמא
בעאַלמע דיקשויט	בעלמא דקשוט
בעאַלפּע	בעל־פּה
בעגאָדים	בגדים
בעגאָלע	בגלוי
בעגאַפּע יאָווע בעגאַפּע יייצע	בגפּו יבֿוא בגפּו יצא
בעגילופֿן	בגילופֿין
בעגילע	בגילוי
בעגילע בערינע	בגילה ברינה
בעגילע־ראָש	בגילוי־ראָש
בעגימאַטריע	בגימטריא
בעגימאַטריע	בגימטריה
בעגעד	בגד
בעדאַלעס	בדלות
בעדאָמאַיִך כאַיִ	בדמיך חיי
בעדאַס	בדעת
בעדויכעק	בדוחק
בעדידי האַווע אוּוודע	בדידי הווה עובֿדה
בעדייע	בדעה
בעדייע־אַכעס	בדעה־אַחת
בעדילאַדאַל	בדיל־דל
בעדילאַדאַל	בדיל־הדל
בעדיִעוועד	בדיעבֿד
בעדיִעק	בדיוק
בעדעק־האַבאַיִס	בדק־הבית
בעדערעך־אַגעוו	בדרך־אַגבֿ
בעדערעך־גוזמע	בדרך־גוזמא
בעדערעך־האַטעווע	בדרך־הטבֿע
בעדערעך־האַלאָצע	בדרך־הלצה
בעדערעך־מאָשל	בדרך־משל
בעדערעך־נעס	בדרך־נס
בעדערעך־קלאַל	בדרך־כּלל
בעהאַאַלויסכע	בהעלותך
בעהאַדראָגע	בהדרגה
בעהאַכנאָע	בהכנעה
בעהאַלוואָע	בהלוואה
בעהאָלע	בהלה
בעהאַסמאָדע	בהתמדה
בעהאַקאָפֿע	בהקפֿה
בעהאָקעץ	בהקיץ
בעהאַר	בהר
בעהאַרכאָווע	בהרחבֿה
בעהיימע	בהמה
בעהיימעס	בהמות
בעהיימעלע	בהמהלע
בעהיימעלעך	בהמהלעך
בעהיימע בעצורעס־אָדעם	בהמה בצורת־אָדם
בעהיימע־גאַסע	בהמה־גסה
בעהיימע־דאַקע	בהמה־דקה
בעהעוול־פּיהעם	בהבֿל־פּיהם
בעהעטער	בהיתּר
בעהעכרעך	בהכרח
בעהען־צידקי	בהן־צידקי
בעהען־שעלי	בהן־שלי
בעהעסעך־האַדאַאַס	בהיסח־הדעת
בעהעסקעם	בהסכּם
בעהעסקעם־קולעם	בהסכּם־כּולם
בעוואַדע	בוודאי
בעוואַס־אַכעס	בבֿת־אַחת
בעוינעס	באונס
בעויסע־האַרעגע	באותו־הרגע
בעויסע־מײַמעד	באותו־מעמד
בעויסע־רעגע	באותו־רגע
בעויסע־שאָ	באותה־שעה
בעויפֿן	באופֿן
בעזאָל	בזול
בעזבושעניצע	בעזבושהניצע
בעזבושעניק	בעזבושהניק
בעזדן	בית־דין
בעזדן־צעדעק	בית־דין־צדק
בעזדן־שאַמאָסים	בית־דין־שמשׂים
בעזדן־שאַמעס	בית־דין־שמשׂ
בעזדן־שטוב	בית־דין־שטוב
בעזדן־שעל־מײַלע	בית־דין־של־מעלה
בעזייעס־אַפּעכאָ	בזעת־אַפּיך
בעזיל־האַזאָל	בזיל־הזול
בעזיל־זאָל	בזיל־זול
בעזן	בית־דין
בעזן־צעדעק	בית־דין־צדק
בעזן־שאַמאָסים	בית־דין־שמשׂים
בעזן־שאַמעס	בית־דין־שמשׂ
בעזן־שטוב	בית־דין־שטוב
בעזן־שעל־מײַלע	בית־דין־של־מעלה
בעזע־האָויפֿן	בזה־האופֿן
בעזע־האַלאָשן	בזה־הלשון
בעזרעס־האַשעם	בעזרת־השם
בעזרעס־האַשעם־ייִסבאָרעך	בעזרת־השם־יתברך
בעטאָך	בתּוך
בעטאַכלעס־האַ	בתּכלית־ה…
בעטאַכלעס־האַסינע	בתּכלית־השׂינאה
בעטאַכלעס־האַפּאַשטעס	בתּכלית־הפּשטות
בעטאַר	ביתּ״ר
בעטאַר	ביתּר
בעטוירעס	בתּורת
בעטוכים	בטוחים
בעטוכעס	בטוחות
בעטועך	בטוח
בעטופּים־אוּווימכוילעס	בתּופּים־ובֿמחולות
בעטעווע	בטבֿע
בעטער	ביתּר
בעיאַד	ביד
בעיאָדאַיִם	בידים
בעיאַד־כאַזאָקע	ביד־חזקה
בעיאַד־ראָמע	ביד־רמה
בעיאַד־רעכאָווע	ביד־רחבֿה
בעיאַד־רעכאָווע־אומלייע	ביד־רחבֿה־ומלאה
בעיוידים	ביודעים
בעיויקער	ביוקר
בעיִטע	בעתּו
בעיין־אויפֿן	באין־אופֿן
בעיין־בריירע	באין־ברירה
בעיינײַ ראָיִסי	בעיני ראָיתי
בעיירעם־אוּווכויסער־קאָל	בעירום־ובֿחוסר־כּל
בעיִם	באם
בעיִסער	באיסור
בעיערושע	בירושה
בעיִקער	בעיקר
בעכאַדראַג	בחדר״ג
בעכאַדרע־כאַדאָרים	בחדרי־חדרים
בעכאַוורוסע	בחבֿרותא
בעכאַזאָקע	בחזקה
בעכאַזאָרע	בחזרה
בעכאָל־אויפֿן	בכל־אופֿן
בעכאָל־טפֿוצעס־ייִסראָעל	בכל־תּפֿוצות־ישׂראל
בעכאָל־כעדרע־טוירע	בקי בכל־חדרי־תּורה
בעכאָצע־כינעם	בחצי־חינם
בעכאַרפּאָסע	בחרפּתו
בעכאַרפּע	בחרפּה
בעכוימער־אוּווילוויינים	בחומר־ובֿלבֿנים
בעכוקויסײַ	בחקותי
בעכוש	בחוש
בעכי־טויוו	בכי־טובֿ
בעכיין	בכן
בעכײַע עוון־פּעקודע	בחיי אבן־פּקודה
בעכיירעם	בחרם
בעכינעם	בחינם
בעכיפּאָזן	בחפּזון
בעכען	בכן
בעכעסקעס	בחזקת־
בעלאַז	בלע״ז
בעלאַכעש	בלחש
בעלאָשן־אַטאָ	בלשון־אַתּה
בעלאָשן־יאָכעד	בלשון־יחיד
בעלאָשן־כיבע	בלשון־חיבה
בעלאָשן־סעגינאָער	בלשון־סגי־נהור
בעלאָשן־ראַבים	בלשון־רבים
בעלוי	בלא
בעלוי־גוזמע	בלא־גוזמא
בעלוי־יוידים	בלא־יודעים
בעלי	בלי־
בעלי־גוזמע	בלי־גוזמא
בעלי־טנײַ	בלי־תּנאַי
בעלי־יעפֿונע	בלי־יפֿונה
בעלי־כאַראָטע	בלי־חרטה
בעלי־מאַסקאָנע	בלי־מסקנא
בעלי־ניידער	בלי־נדר
בעלי־סאָפֿעק	בלי־ספֿק
בעלי־קאַוואָנע	בלי־כּוונה
בעלי־שום־טײַנע	בלי־שום־טענה
בעלי־שום־סאָפֿעק	בלי־שום־ספֿק
בעלעוו־וואָנעפֿעש	בלבֿ־ונפֿש
בעלעס־בריירע	בלית־ברירה
בעמאַטאָנע	במתּנה
בעמאָקעם שעיין איש	במקום שאין איש
בעמייזיד	במזיד
בעמיילע	במילא
בעמיצווויסאָוו	במיצוותיו
בעמעקעך	במקח
בעמעקעך־האַשאָווע	במקח־השווה
בעמעשעך	במשך
בען	בן
בענאָדעם	בן־אָדם
בענאָק	בנאָק
בענאַרבאָיִם	בן־אַרבעים
בענבאַיִס	בן־בית
בענבעקוע	בן־פּקועה
בענבריס	בן־ברית
בענגיל	בן־גיל
בענדאַאַס	בן־דעת
בענדאָר	בן־דור
בען־האַנידע	בן־הנידה
בענהאָראַוו	בן־הרבֿ
בענויעג־שעבאָוילעם	בנוהג־שבעולם
שעבאָוילעם	שבעולם
בענזאָכער	בן־זכר
בענזוג	בן־זוג
בענזקונים	בן־זקונים
בענטויווים	בן־טובֿים
בענטוירע	בן־תּורה
בענטישים	בן־תּישעים
בעניאָכעד	בן־יחיד
בעניאָמען	בנימין
בעניאָמענס	בנימינס
בעניאָמענען	בנימינען
בעניאַקער	בן־יקיר
בען־ייִסראָעל	בן־ישׂראל
בעניכעסע	בניחותא
בענימעס	בנימוס
בענימעס	בנעימות
בענימעסדיק	בנעימותדיק
בענימעסדיקער	בנעימותדיקער
בענימעסדיקע	בנעימותדיקע
בענימעסדיקן	בנעימותדיקן
בענימצע	בנימצא
בעניר	בן־עיר
בענמיילעך	בן־מלך
בען־מײַמאָן	בן־מימון
בען־נויעך	בן־נח
בען־נעוואָט	בן־נבֿט
בען־סוירער־אומוירע	בן־סורר־ומורה
בען־סירע	בן־סירא
בענסקונים	בן־זקונים
בענעגייע	בנוגע
בענעמאָנעס	בנאמנות
בענפּעקוע	בן־פּקועה
בענציִען	בן־ציון
בען־קאַיאָמע	בן־קימא
בענשיווים	בן־שיבֿעים
בענשישים	בן־שישים
בענשמוינים	בן־שמונים
בעסאָד	בסוד
בעסאָד־סוידעס	בסוד־סודות
בעסאָך	בתוך
בעסאַלמען	בית־עלמין
בעסויכעם	בתוכם
בעסוילעם	בית־עולם
בעסיִאַטע־דעשמײַע	בסיעתּא־דשמיא
בעסייווער־פּאָנעם־יאָפֿעס	בסבֿר־פּנים־יפֿות
בעסייסער	בסתר
בעסמעדרעש	בית־מדרש
בעסמעדרעשל	בית־מדרשל
בעסעכאַקל	בסך־הכּל
בעעלעף־מעכילעס	באלף־מחילות
בעעמונאָסי	באמונתי
בעעמונע	באמונה
בעעמונע־שליימע	באמונה־שלמה
בעעמעס	באמת
בעעצעם	בעצם
בעערעך	בערך
בעפּאַכיי־נעפֿעש	בפּחי־נפֿש
בעפּאַשטעס	בפּשטות
בעפּויעל	בפּועל
בעפּויעל־מאַמעש	בפּועל־ממש
בעפּישעט־יאָדאַיִם־וועראַגלאַיִם	בפּישוט־ידים־ורגלים
בעפּע־מאָלע	בפּה־מלא
בעפּע־עכעד	בפּה־אחד
בעפֿומבי	בפֿומבי
בעפֿיירעש	בפֿירוש
בעפֿיירעש הוטנע	בפֿירוש הותּנה
בעפֿערעסיע	בפֿרהסיא
בעצאַוואָע	בצוואה
בעצאַלעל	בצלאל
בעצאַלעלס	בצלאלס
בעצאַלעלן	בצלאלן
בעצורעס	בצורת־
בעצורעס־אָדעם	בצורת־אָדם
בעציבער	בציבור
בעצימצעם	בצימצום
בעקאַבאָלע	בקבלה
בעקאַוואָנע	בכּוונה
בעקאַוו־האַבריִע	בקוו־הבריאה
בעקאַוו־האַבריִעס	בקוו־הבריאות
בעקאַוו־האַכאַיִם־וועהאַשאָלעם	בקוו־החיים־והשלום
בעקאָוועד	בכּבֿוד
בעקאָוועד־גאָדל	בכּבֿוד־גדול
בעקאָוועדיק	בכּבֿודיק
בעקאָלע־קוילעס	בקולי־קולות
בעקאָל־קוילעס	בקולי־קולות
בעקאָל־ראָם	בקול־רם
בעקאַן	בכּאַן
בעקאַק	בק״ק
בעקאָרעוו	בקרובֿ
בעקויוועד־ראָש	בכּובֿד־ראָש
בעקויעך	בכּוח
בעקיוון	בכּיוון
בעקיִיִם	בקיים
בעקיסע בעקויסע בעקײַסע	בכּיסו בכּוסו בכּעסו
בעקיִע	בקיאה
בעקיִעס	בקיאות
בעקיצער	בקיצור
בעקעהילע־קדוישע	בקהילה־קדושה
בעקעשער	בקשר
בעראַבים	ברבים
בעראָוו־אַם	ברובֿ־עם
בעראַכוועסדיק	ברחבֿותדיק
בעראָכל ביטכאָ האַנאַקעטע	ברחל בתּך הנאַקעטע
בעראָכל ביטכאָ האַקטאַנאָ	ברחל בתּך הקטנה
בעראָצן	ברצון
בעראָש	בראָש
בערוישע־ווערובע	בראשו־ורובו
בערומע־שעל־אוילעם	ברומו־של־עולם
בערועך־האַקוידעש	ברוח־הקודש
בערייש־געליי	בריש־גלי
בעריע	בריה
בעריען	בריהן
געבעריעט	געבריהט
בעריע־ניפֿלאָע	בריה־נפֿלאה
בעריעש	בריהש
בעריעשער	בריהשער
בעריעשע	בריהשע
בעריעשן	בריהשן
בעריעשאַפֿט	בריהשאַפֿט
בעריעשקייט	בריהשקייט
בערעוועך	ברווח
בערעמעז	ברמז
בעשאַטע	בשעתּה
בעשאַטע	בשעתּו
בעשאַטעם	בשעתּם
בעשאַלאַך	בשלח
בעשאָלעם	בשלום
בעשאָלעם־וועשאַלווע	בשלום־ושלווה
בעשאַס	בשעת
בעשאַס־האַטכאַק	בשעת־הדחק
בעשאַס־מײַסע	בשעת־מעשׂה
בעשוטפֿעס	בשותּפֿות
בעשויגעג	בשוגג
בעשום־אויפֿן	בשום־אופֿן
בעשום־איניען־וועויפֿן	בשום־ענין־ואופֿן
בעשט	בעש״ט
בעשײַכעס	בשײַכות
בעשיין־וואָאַיִן	בשן־ועין
בעשעווע־כאָכמעס	בקי בשבֿע־חכמות
בעשעם־אומאַלכעס	בשם־ומלכות
בעשעם־אָמרוי	בשם־אומרו
בעשעם־וועמאַלכעס	בשם־ומלכות
בעשעפֿע	בשפֿע
בראַכיע	ברכיה
בראָכע	ברכה
בראָכעס	ברכהס
בראָכען	ברכהן
בראָכע־לעוואַטאָלע	ברכה־לבֿטלה
בראָכעס	ברכות
ברויגעז	ברוגז
ברויגעז־טאַנץ	ברוגז־טאַנץ
ברויגעזן	ברוגזן
ברויִם	ברואים
ברוכים־האַבאָיִם	ברוכים־הבאָים
ברוכים־האַיוישווים	ברוכים־היושבֿים
ברוריע	ברוריה
בריט יאָסעף טרומפּעלדאָר	בריתּ יוסף תּרומפּלדור
ברײַסע	ברײַתא
בריירע	ברירה
בריישעס	בראשית
בריס	ברית
בריס־כאַדאָשע	ברית־חדשה
בריסמילע	ברית־מילה
בריִע	בריאה
בריִעס	בריאות
בריִעס־אוילעם	בריאת־עולם
בריִעס־האַגוף	בריאות־הגוף
בריִעס־האָוילעם	בריאת־העולם
גאַבאָיִם	גבאָים
גאַבאָעס	גבאָות
גאַבע	גבאי
גאַבעס	גבאיס
גאַבעטע	גבאיטע
גאַבעטעס	גבאיטעס
גאָג־אומאָגעג	גוג־ומגוג
גאָגמעגאָג	גוג־מגוג
גאָד	גד
גאָדל	גדול
גאַדלאָנים	גדלנים
גאַדלאָנעס	גדלנות
גאָדל־בעיִסראָעל	גדול־בישׂראל
גאָדלדיק	גדולדיק
גאָדל־האַדאָר	גדול־הדור
גאָדלע	גדלע
גאַדלען	גדלן
גאַדלענטע	גדלנטע
גאַדלעס	גדלות
גאַווראָנים	גבֿרנים
גאַווריִעל	גבֿריאל
גאַווריִעלס	גבֿריאלס
גאַווריִעלן	גבֿריאלן
גאַוורען	גבֿרן
גאַוורעס	גבֿרות
גאָזאַלנו	גזלנו
גאַזלאָנים	גזלנים
גאַזלאָניש	גזלניש
גאַזלאָנעס	גזלנות
גאַזלען	גזלען
גאַזלענען	גזלענען
גאַזלעווויסטווע	גזלעווויסטווע
גאַזלעווויע	גזלעווויע
גאַזלען	גזלן
גאַזלענטע	גזלנטע
גאָיאַלים	גואלים
גאָיִם	גויים
גאָיִם־גמורים	גויים־גמורים
גאָיִש	גוייִש
גאַלאָכים	גלחים
גאַלגאַלים	גלגלים
גאַלגל	גלגל
גאַלגל האַכויזער	גלגל החוזר
גאַלגל האַכויזער באָוילעם	גלגל החוזר בעולם
גאַלגל כויזער	גלגל חוזר
גאַלגל כויזער באָוילעם	גלגל חוזר בעולם
גאָליעס	גלית
גאַלכעס	גלחות
גאַל־עד	גל־עד
גאַלעך	גלח
גאַלעכס	גלחס
גאָלעס	גלות
גאָלעס	גלות־
גאָלעס־באָוול	גלות־בבֿל
גאָלעס־האַשכינע	גלות־השכינה
גאָלעס־מיצראַיִם	גלות־מצרים
גאַל־שעל־אַצאָמעס	גל־של־עצמות
גאַם	גם
גאַם־אַטעם	גם־אַתּם
גאַמזו לעטויווע	גם זו לטובֿה
גאָמער	גמור
גאַנאָווים	גנבֿים
גאַנווע	גנבֿע
גאַנוועסט	גנבֿעסט
גאַנוועסטו	גנבֿעסטו
גאַנוועט	גנבֿעט
געגאַנוועט	געגנבֿעט
גאַנווענען	גנבֿענען
גאַניידן	גן־עדן
גאַניידן־האַטאַכטן	גן־עדן־התּחתּון
גאַניידן־טאַכטן	גן־עדן־תּחתּון
גאַנייוויש	גנבֿהש
גאַנייווישער	גנבֿהשער
גאַנייווישע	גנבֿהשע
גאַנייווישן	גנבֿהשן
גאַנייוויש	גנבֿיש
גאַנייווישער	גנבֿישער
גאַנייווישע	גנבֿישע
גאַנייווישן	גנבֿישן
גאַנייווע	גנבֿה
גאַנעוו	גנבֿ
גאַנעווטע	גנבֿטע
גאָען	גאָון
גאַרגערעס	גרגרת
גאָרמים	גורמים
גאָרעש	גרוש
גאַשמיִעס	גשמיות
גאַשמיִעסדיק	גשמיותדיק
גדאָרים	גדרים
גדוילים	גדולים
גדוילים־בעיִסראָעל	גדולים־בישׂראל
גדוילע	גדולה
גדוילע־האַדאָר	גדולי־הדור
גוואַר	גבֿר
גוואַר־אַלים	גבֿר־אַלים
גוואַר־כאַלעש	גבֿר־חלש
גוווּל	גבֿול
גוווּרע	גבֿורה
גוויִעס־איידעס	גבֿית־עדות
גוויר	גבֿיר
גווירטע	גבֿירטע
גוויריש	גבֿיריש
גווירנטע	גבֿירינטע
גוזמאָעס	גוזמאָות
גוזמע	גוזמא
גוזמעדיק	גוזמאדיק
גוי	גוי
גוי־גאָמער	גוי־גמור
גויווער	גובֿר
גויזער	גוזר
גויזער־טאָנעס	גוזר־תּענית
גוילאָמים	גולמים
גוילים	גולים
גוילע	גולה
גוילע	גולי־
גוילעם	גולם
גוילעמס	גולמס
גוילע־ספֿאַרד	גולי־ספֿרד
גוימל	גומל
גוינעז	גונז
גויסען	גוסען
גויסענען	גוסענען
גויסעס	גוסס
גויסעסן	גוססן
גויע	גויה
גויעל	גואל
גויעלים	גואלים
גויעל־צעדעק	גואל־צדק
גויראָלעס	גורלות
גוירל	גורל
גוירלדיק	גורלדיק
גוירעם	גורם
גוירעם	גורם
גוירעס	גורס
גוישן	גושן
גוף	גוף
גוף־האַמײַסע	גוף־המעשׂה
גופֿע	גופֿא
גזאַר	גזר
גזאַרדין	גזר־דין
גזיילע	גזלה
גזיילעס	גזלות
גזיירע	גזירה
גזיירעס־טאַך	גזירת־תּ״ח
גזיירעס־טאַך וועטאַט	גזירת־תּ״ח ותּ״ט
גזיירע־שאָווע	גזירה־שווה
גיבוירים	גיבורים
גיבויריש	גיבוריש
גיבער	גיבור
גיבעריש	גיבוריש
גידופֿים	גידופֿים
גידל־באָנים	גידול־בנים
גידן	גידין
גידעף	גידוף
גיִורים	גיורים
גיטין	גיטין
גײַווסאָנים	גאוותנים
גײַווסן	גאוותן
גײַווע	גאווה
גייעס	גאות
גײַעס	גיות
גײַפֿסאָנים	גאוותנים
גײַפֿסן	גאוותן
גיירושים	גירושים
גיירים	גרים
גיירעש	גירוש
גיירעש	גרוש
גילגולים	גילגולים
גילגל	גילגול
גילגל־האַנעפֿעש	גילגול־הנפֿש
גילגל־מעכילעס	גילגול־מחילות
גילגל־שעלעג	גילגול־שלג
גילויִם	גילויים
גילויען	גליון
גיליוינעס	גליונות
גיליען	גליון
גילע	גילוי
גילע־אַרויעס	גילוי־עריות
גילע־אַרײַעס	גילוי־עריות
גילע־עליאָהו	גילוי־אליהו
גילע־שכינע	גילוי־שכינה
גימאַטריע	גימטריא
גימל	ג
גימל	גימל
גיִער	גיור
גירסאָעס	גירסאָות
גירסע	גירסא
גירסע־דעיאַנקעסע	גירסא־דינקותא
גלוכים	גלוחים
גלילע	גלילה
גמאַר	גמר
גמאַר טאָוו	גמר טובֿ
גמאַר כסימע טויווע	גמר חתימה טובֿה
גמורים	גמורים
גמורע	גמורה
גמילעס־כאַסאָדים	גמילות־חסדים
גמילעס־כסאָדים	גמילות־חסדים
גמילעס־כעסעד	גמילות־חסד
גניזע	גניזה
גנײַ	גנאַי
גנייוויש	גנבֿהש
גנייוויש	גנבֿיש
גנייווע	גנבֿה
גנייוועס	גנבֿות
גסיסע	גסיסה
געדאַליאָהו	גדליהו
געדאַליאָהוס	גדליהוס
געדאַליע	גדליה
געדאַליעס	גדליהס
געדאַליען	גדליהן
געדולע	גדולה
געדי	גדי
געדער	גדר
געהענעם	גיהנום
געוויר	גבֿיר
געווירטע	גבֿירטע
געוויריש	גבֿיריש
געווירנטע	גבֿירינטע
געויניי־האַדאָר	גאוני־הדור
געוינים	גאונים
געויניש	גאוניש
געוינעס	גאונות
געולע	גאולה
געזע	גזע
געט	גט
געטן	גטן
געגעט	געגט
געגעטער	געגטער
געגעטע	געגטע
געגעטן	געגטן
געגעטנס	געגטנס
געטן	גיטין
געלועך	גלוח
געמאָרע	גמרא
געמאָרעס	גמרות
געניידעם	גן־עדן
גענייוויש	גנבֿהש
גענייוויש	גנבֿיש
גענייווע	גנבֿה
גענעם	גיהנום
געסראָכע	געסרחה
גער	גר
גערטע	גרטע
גער־צעדעק	גר־צדק
גערשן	גרשם
גערשנס	גרשמס
גערשן	גרשון
גערשנס	גרשונס
געשאָכטן	געשחטן
געשעם	גשם
גרויגרעס־דעראַבי־צאָדעק	גרוגרת־דרבי־צדוק
גרוינעם	גרונם
גרושים	גרושים
גרושע	גרושה
גשאָמים	גשמים
דאַאַס	דעת
דאַאַס־האַקאָאָל	דעת־הקהל
דאַבערן	דברן
דאַבער	דבר
דאַבערסט	דברסט
דאַבערט	דברט
דאַבערסטו	דברסטו
דאַבראָנים	דברנים
דאַברען	דברן
דאָגים	דגים
דאָגעש	דגוש
דאָגעש	דגש
דאָוו	דובֿ
דאָוויד	דוד
דאָווידס	דודס
דאָווידן	דודן
דאָווידל	דודל
דאָווידלס	דודלס
דאָווידלען	דודלען
דאָוויד האַמיילעך	דוד המלך
דאָוויד האַמיילעכס	דוד המלכס
דאָוועראַכער	דבֿר־אַחר
דאָווער־גאָדל	דבֿר־גדול
דאָווער־שעביקדושע	דבֿר־שבקדושה
דאַווקע	דווקא
דאַיאָנים	דיינים
דאַיאָנעס	דיינות
דאַייינו	דיינו
דאַכקעס	דחקות
דאַלייסים	דלותים
דאַלעט	ד
דאַלעט	דלתּ
דאַלעט אַל דאַלעט	דלתּ על דלתּ
דאַלעט אַמעס	דלתּ אַמות
דאַלעס	דלות
דאַלפֿאָנים	דלפֿונים
דאַלפֿן	דלפֿון
דאָם	דם
דאַם	דם
דאָמים	דמים
דאַם־נידע	דם־נידה
דאַמסאָנים	דם־שׂונאים
דאַמסוינע	דם־שׂונא
דאַמעסעק	דמשׂק
דאָן	דן
דאַן	דן
דאַניִעל	דניאל
דאַניִעלס	דניאלס
דאַניִעלן	דניאלן
דאַס	דת
דאַף	דף
דאַפּים	דפּים
דאַפֿקע	דווקא
דאַקע	דקה
דאַקע־מין־האַדאַקע	דקה־מן־הדקה
דאָר	דור
דאָר־דוירעס	דור־דורות
דאַרדעקע	דרדקי
דאַרדעקע־מעלאַמדים	דרדקי־מלמדים
דאַרדעקע־מעלאַמעד	דרדקי־מלמד
דאָר־האַמאַבל	דור־המבול
דאָר־האַמידבער	דור־המידבר
דאָר־האַפֿלאָגע	דור־הפֿלגה
דאָרעם	דרום
דאַרקע־שאָלעם	דרכּי־שלום
דאַרשאָנים	דרשנים
דאַרשן	דרשן
דאַרשען	דרשען
דאַרשענען	דרשענען
דגאָלים	דגלים
דגושים	דגושים
דגיישים	דגשים
דוגמאָעס	דוגמאָות
דוגמע	דוגמא
דוואַרטוירע	דבֿר־תּורה
דוואָרים	דבֿרים
דוואָרים־בטיילים	דבֿרים־בטלים
דוואָרים בעגייוו	דבֿרים בגוו
דוואָרים־בעטיילים	דבֿרים־בטלים
דוואָרים־גדוילים	דבֿרים־גדולים
דוואָרים האָאָמדים בערומע־שעלוילעם	דבֿרים העומדים ברומו־של־עולם
דוואָרים־קעהאַוואָיאָסן	דבֿרים־כּהוויותן
דוואָרים־קעיויסן	דבֿרים־כּהיותן
דוואָרים־שעביקדושע	דבֿרים־שבקדושה
דוואַרכאָכמע	דבֿר־חכמה
דוואַרכאָל	דבֿר־חול
דוואַר־מאַלכעס	דבֿר־מלכות
דוואַרצדאָקע	דבֿר־צדקה
דוואַרשעקער	דבֿר־שקר
דוווירע	דבֿורה
דוווירעס	דבֿורהס
דוווירען	דבֿורהן
דוווירעלע	דבֿורהלע
דוווירעלעס	דבֿורהלעס
דוווירעלען	דבֿורהלען
דוווירע האַנעוויִע	דבֿורה הנבֿיאה
דווייקען	דבֿקען
דווייקענען	דבֿקענען
דווייקעס	דבֿקות
דויוו	דובֿ
דויווער־שקאָרים	דובֿר־שקרים
דויכע	דוחה
דויכעק	דוחק
דויכע־שאַבעס	דוחה־שבת
דוימעם	דומם
דויפֿעק	דופֿק
דוירעס	דורות
דוירעס	דורס
דוכן	דוכן
דוכענען	דוכנען
דוקסים	דוכּוסים
דוקעס	דוכּוס
דוקעסים	דוכּוסים
דיבוקים	דיבוקים
דיבורים	דיבורים
דיבעק	דיבוק
דיבער	דיבור
דיוורע־האַיאָמים	דבֿרי־הימים
דיוורע־טוירע	דבֿרי־תּורה
דיוורע־כאָכמע	דבֿרי־חכמה
דיוורעכאָל	דבֿרי־חול
דיוורע־מאַלכעס	דבֿרי־מלכות
דיוורע־עלויקים־כאַיִם	דבֿרי־אלוקים־חיים
דיוורע־צדאָקע	דבֿרי־צדקה
דיוורע־שעקער	דבֿרי־שקר
דײַגע	דאגה
דײַגען	דאגהן
דײַגענען	דאגהנען
דײַגעס־האַקלאַל	דאגת־הכּלל
דײַגעס־פּאַרנאָסע	דאגת־פּרנסה
דײַ־וועהויסער	די־והותר
דייע	דעה
דײַען	דיין
דייפֿעק	דפֿק
דייקע	דייקא
דײַקע	דייקא
דילמאַטע	דלמטה
דילמײַלע	דלמעלה
דימיוינעס	דמיונות
דימיען	דמיון
דין	דין
דין־וועכעזשבם	דין־וחשבון
דינטוירע	דין־תּורה
דינע	דינה
דינע־דעמאַלכעסע	דינא־דמלכותא
דינע־מאָמענעס	דיני־ממונות
דינע־נעפֿאָשעס	דיני־נפֿשות
דינע־קאַשרעס	דיני־כּשרות
דיצע	דיצה
דיקדוקים	דיקדוקים
דיקדוקע־אַניִעס	דיקדוקי־עניות
דיקדעק	דיקדוק
דירע	דירה
דכאַק	דחק
דלילע	דלילה
דמײַ	דמאי
דע…	ד…
דעגל	דגל
דעהײַנע	דהײַנו
דעווער	דבֿר
דעוירײַסע	דאורײַתא
דעלי	דלי
דע־לעאָן	די־ליאון
דעצאַך	דצ״ך
סימען־דעצאַך	סימן־דצ״ך
דעצאַך אַדאַש בעאַכאַב	דצ״ך עד״ש באח״ב
דעקאַק	דק״ק
דעקעהילע־קדוישע	דקהילה־קדושה
דערהאַרגען	דערהרגען
דערהאַרגע	דערהרגע
דערהאַרגעסט	דערהרגעסט
דערהאַרגעסטו	דערהרגעסטו
דערהאַרגעט	דערהרגעט
דערהאַרגענען	דערהרגענען
דעריקער	דערעיקר
דעריקערשט	דערעיקרשט
דערעך	דרך
דערעך־אַגעוו	דרך־אַגבֿ
דערעך־אוילעם	דרך־עולם
דערעך־האָוילעם	דרך־העולם
דערעך־האַטעווע	דרך־הטבֿע
דערעך־האַיאָשער	דרך־הישר
דערעך־האַמיילעך	דרך־המלך
דערעך־האַסייכל	דרך־השׂכל
דערעך־האַשאָלעם	דרך־השלום
דערעך־מיילעך	דרך־מלך
דערעכערעץ	דרך־ארץ
דערעכערעצדיק	דרך־ארצדיק
דערעכערעצדיקער	דרך־ארצדיקער
דערעכערעצדיקע	דרך־ארצדיקע
דערעכערעצדיקן	דרך־ארצדיקן
דערעכערעצדיקס	דרך־ארצדיקס
דערעך־שאָלעם	דרך־שלום
דערקאַאַסן	דערכּעסן
דערראַגזען	דעררגזען
דערראַגזענען	דעררגזענען
דראָכים	דרכים
דראַש	דרש
דראָשע	דרשה
דראָשעס	דרשות
דראָשע־געשאַנק	דרשה־געשאַנק
דרוש	דרוש
דריסעס־האָרעגל	דריסת־הרגל
דשאָיִם־וואַסאָווים	דשאָים־ועשׂבֿים
האַ…	ה…
האַאַזינו	האזינו
האָאַראַמי	האַרמי
האַגאָדע	הגדה
האַגאָדע־שעל־פּייסעך	הגדה־של־פּסח
האַגאָדל האַגיבער וועהאַנוירע	הגדול הגיבור והנורא
האַגאַם	הגם
האַגאָע	הגהה
האַגבאָע	הגבהה
האַגבע	הגבה
האַגדאָמע	הקדמה
האַגונים	הגונים
האַגונע	הגונה
האָגן	הגון
האַדאַסים	הדסים
האַדאַסע	הדסה
האַדגאָשע	הדגשה
האָד־מאַלכוסע	הוד־מלכותו
האָד־מאַלכעס	הוד־מלכות
האָדעס	הדס
האָדעסל	הדסל
האָדער	הדר
האַדראָגע	הדרגה
האַדראָכע	הדרכה
האַדרען	הדרן
האַדרעס־פּאָנעם	הדרת־פּנים
האַדרעס־פּענעמער	הדרת־פּנימער
האַוואָלים	הבֿלים
האַוואָנע	הבֿנה
האַוואָרע	הבֿרה
האַוודאָלע	הבֿדלה
האַווויעס־האָוילעם	הוויות־העולם
האַווויעס־אוילעם	הוויות־עולם
האַווייל־האַוואָלים	הבֿל־הבֿלים
האַווײַע	הוויה
האַווײַע	העוויה
האַזמאָנע	הזמנה
האָזע	העזה
האַזקאָרע	הזכּרה
האַזקאָרעס־נעשאָמעס	הזכּרת־נשמות
האַטאָקע	העתּקה
האַטיקוואָ	התּיקווה
האַיאָקער	היקר
האַיויצע לאָנו מיזע	היוצא לנו מזה
האַיויצע מידוואָריינו	היוצא מדבֿרינו
האַיויצע מיזע	היוצא מזה
האַיִטאָכן	היתּכן
האַיעלעד איינענו	הילד איננו
האָיִקער שאָכאַכטי	העיקר שכחתּי
האַכאָנע	הכנה
האַכאָסעם־מאַטאָ	החתום־מטה
האַכבאָדע	הכבדה
האַכלאָטע	החלטה
האַכנאָסע	הכנסה
האַכנאָסעס־אָרכים	הכנסת־אורחים
האַכנאָסעס־קאַלע	הכנסת־כּלה
האַכנאָע	הכנעה
האַכסומים־מאַטא	החתום־מטה
האַכראָזע	הכרזה
האַכראָע	הכרעה
האַכשאָרע	הכשרה
האַלאָכע	הלכה
האַלאָכע לעמוישע מיסינײַ	הלכה למשה מסיני
האַלאָצע	הלצה
האַלבאָשע	הלבשה
האַלוואָע	הלוואה
האַליטייני	הלעיטני
האַליטייניק	הלעיטניק
האַלמײַ	הלמאַי
האַלעווײַ	הלוואַי
האָלעך מוישע־מאָרטכע	הלך משה־מרדכי
האַלעל	הלל
האַלעלוּיאָ	הללויה
האַלעמײַ	הלמאַי
האַמאַוודיל	המבֿדיל
האַמאַוודל	המבֿדיל
האַמאַפּל	המפּיל
האַמאַפּע	המפּה
האַמוין	המון
האַמוין־אַם	המון־עם
האַמויצע	המוציא
האַמייליץ	המליץ
האַמיילעך	המלך
האַמכונע	המכונה
האַמעכונע	המכונה
האָמען	המן
האָמען האַראָשע	המן הרשע
האָמענטאַש	המן־טאַש
האַמעפֿאָרסעם	המפֿורסם
האַמעפֿורסעם	המפֿורסם
האַמצאָע	המצאה
האַנאָווי	הנבֿיא
האַנאָכע	הנחה
האַנאַל	הנ״ל
האַנאָע	הנאה
האַנהאָגע	הנהגה
האַניסקער לעייל	הניזכּר לעיל
האַנעוויִע	הנבֿיאה
האַנע־מילע	הני־מילי
האַסאָגע	השׂגה
האַסאָגעס־גוווּל	הסגת־גבֿול
האַסבאָרע	הסברה
האַסכאָלע	התחלה
האַסמאָדע	התמדה
האַס־מילעהאַסקער	הס־מלהזכּר
האַסקאָלע	השׂכּלה
האַסקאָמע	הסכּמה
האַסקאָרע	הזכּרה
האַסקאָרעס־נעשאָמעס	הזכּרת־נשמות
האַסראָע	התראה
האַפּע שעאָסער האַפּע שעהיטער	הפּה שאָסר הפּה שהתּיר
האַפֿאָכים	הפֿכים
האַפֿטאָכע	הבֿטחה
האַפֿטוירע	הפֿטורה
האַפֿלע־וואָפֿעלע	הפֿלא־ופֿלא
האַפֿסאָקע	הפֿסקה
האָפֿעך	הפֿוך
האַצאַדיק	הצדיק
האַצאָלע	הצלה
האַצלאָכע	הצלחה
האַצפֿירע	הצפֿירה
האַקאָדעש	הקדוש
האַקאָדעש־באָרכו	הקדוש־ברוך־הוא
האַקאָפֿע	הקפֿה
האַקאָפֿעס	הקפֿות
האָקיצאָ	הקיצה
האַקכאָשע	הכּחשה
האַקל־באַקל	הכּל־בכּל
האַקלאַל	הכּלל
האַקל־באַקל־מיקל	הכּל־בכּל־מכּל
האַקל־באַקל־מיקל־פֿלעקל	הכּל־בכּל־מכּל־פֿלעקל
האַקל מוכן	הכּל מוכן
האַקפּאָדע	הקפּדה
האַקצאַקאָסע	הכּצעקתה
האָראַוו	הרבֿ
האַראַס־אוילעם	הרת־עולם
האַראָשע	הרשע
האַרגען	הרגען
האַרגענען	הרגענען
האַרגע	הרגע
האַרגעסט	הרגעסט
האַרגעסטו	הרגעסטו
האַרגעט	הרגעט
געהאַרגעט	געהרגעט
געהאַרגעטער	געהרגעטער
געהאַרגעטע	געהרגעטע
געהאַרגעטן	געהרגעטן
געהאַרגעטנס	געהרגעטנס
האַר־האַבאַיִס	הר־הבית
האַר־האַזייסים	הר־הזיתים
האַרוגים	הרוגים
האַרוגע	הרוגי־
האַריגע	הריגה
האַריגעס	הריגות
האַריי־אַט	הרי־אַתּ
האַריי־אַט מעקודעשעס	הרי־אַתּ מקודשת
האָרים־אוגוואָעס	הרים־וגבֿעות
האָרישן	הראשון
האַרכאָווע	הרחבֿה
האַרכאָוועדיק	הרחבֿהדיק
האַרכאָוועס־האַדאַאַס	הרחבֿת־הדעת
האַר־סעיִר	הר־שׂעיר
האָרעג	הרוג
האָרע־כוישעך	הרי־חושך
האַרקאָווע	הרכּבֿה
האַרשאָע	הרשאה
האַשאָוועס־אַוויידע	השבֿת־אַבֿדה
האַשאָרע	השערה
האַשאָרעס	השערות
האַשאָרעס־האַנעפֿעש	השאָרת־הנפֿש
האַשבאָע	השבעה
האַשגאָכע	השגחה
האַשגאָכע־עליוינע	השגחה־עליונה
האַשגאָכע־פּראָטעס	השגחה־פּרטית
האַשטאָנע	השתּנה
האַשלאָמע	השלמה
האַשמאָטע	השמטה
האַשעם	ד׳
האַשעם	ה׳
האַשעם יאַציליינו	השם יצילנו
האַשעם ייִנקאָם דאָמוי	השם ינקום דמו
האַשעם ייִנקאָם דאָמאָם	השם ינקום דמם
האַשעם־ייִסבאָרעך	השם־יתברך
האַשעם ייִשמעריינו	השם ישמרנו
האַשעם יעראַכעם	השם ירחם
האַשפּאָע	השפּעה
האַשפּאָעס	השפּעות
האַשקאָמע	השכּמה
האַשקאָפֿע	השקפֿה
האַשקאָפֿעס	השקפֿות
הו האַדין	הוא הדין
הויד	הוד
הוידאָע	הודאה
הוידאָע	הודעה
הוידע	הודו
הויווע	הווה
הוילעך	הולך
הוילעכן	הולכן
הוילעך־ראָכיל	הולך־רכיל
הוילעך־ראָכל	הולך־רכיל
הוין־ראַוו	הון־רבֿ
הויסאָפֿע	הוספֿה
הויסאָפֿעס	הוספֿות
הויצאָע	הוצאה
הויצאָעס	הוצאָות
הויצאָעס־האַדערעך	הוצאָות־הדרך
הויראָע	הוראה
הויריִעס	הוריות
הוירעג	הורג
הוירעגן	הורגן
הוירעג־־נעפֿאָשעס	הורג־נפֿשות
הוירעג־נעפֿאַשעס	הורג־נפֿשות
הוישײַנע	הושענא
הוישײַנעס	הושענות
הוישײַנע־ראַבע	הושענא־רבה
הוישייע	הושע
הורדעס	הורדוס
הידורים	הידורים
הידער	הידור
היי	ה
היי	הא
היידעד	הידד
היי־האַיעדיִע	הא־הידיעה
הייטעוו	היטבֿ
הייכאָלים	היכלים
הייכאָלעס	היכלות
הייכל	היכל
הייכל־האַקוידעש	היכל־הקודש
הייכע־טימצע	היכא־תּימצא
הײַנע	הײַנו
הײַנע־האַך	הײַנו־הך
הײַעם	היום
הײַעם־טעאַמציינו	היום־תּאַמצנו
הייפּעך	היפּוך
הייפּעכדיק	היפּוכדיק
הילולע	הילולא
הילולע־וועכינגע	הילולא־וחינגא
הילכעס	הילכות
הילכעסע־לימשיכע	הילכתא־לימשיחא
הילעך	הילוך
הילעל	הלל
הילעל האַזאָקן	הלל הזקן
היניי	הנה
היסבוידעדעס	התבודדות
היסבוינענעס	התבוננות
היסגאַלעס	התגלות
היסוירערעס	התעוררות
היסטאַדרוט	הסתּדרותּ
היסטאַלקעס	הסתּלקות
היסטאַפּקעס	הסתּפּקות
היסכאַסקעס	התחזקות
היסכײַוועס	התחײַבֿות
היסכײַוועסן	התחײַבֿותן
היסלײַוועס	התלהבֿות
היסמאַנעס	התמנות
היסנאַגדעס	התנגדות
היסנאַצלעס	התנצלות
היסנײַגעס	התנהגות
היספּײַלעס	התפּעלות
היסקאַרוועס	התקרבֿות
היסרוימעמעס	התרוממות
היפּוכים	היפּוכים
היצטאַרכעס	הצטרכות
הירהורים	הירהורים
הירהורע־אַוויירע	הירהורי־עבֿירה
הירהורע־טשוּווע	הירהורי־תּשובֿה
הירער	הירהור
הירער־אַוויירע	הירהור־עבֿירה
הירער־טשוּווע	הירהור־תּשובֿה
הישטאַדלעס	השתּדלות
הישטאַפּכעס	השתּפּכות
הישטאַפּכעס־האַלעוו	השתּפּכות־הלבֿ
הישטאַפּכעס־האַנעפֿעש	השתּפּכות־הנפֿש
העאָרע	הערה
העאָרעס	הערות
העגדיישים	הקדשים
העגדעש	הקדש
העדיויטים	הדיוטים
העדיעט	הדיוט
העדיעט קויפֿעץ בעראָש	הדיוט קופֿץ בראָש
העוודיילים	הבֿדלים
העוודל	הבֿדל
העוול	הבֿל
העוול־האַוואָלים	הבֿל־הבֿלים
העוול־האַוואָלימדיק	הבֿל־הבֿלימדיק
העזייקעס	היזקות
העזעק	היזק
העטיירים	היתּרים
העטער	היתּר
העטער־איסקע	היתּר־עיסקא
העטער־הויראָע	היתּר־הוראה
העטער־שכיטע	היתּר־שחיטה
העיויס	היות
העכרייעך	הכרח
העכרעך	הכרח
העכשיירים	הכשרים
העכשער	הכשר
העמשייכים	המשכים
העמשעך	המשך
הען	הן… הן…
הען־צעדעק	הן־צדק
העסאָפֿע	הוספֿה
העסאָפֿעס	הוספֿות
העסעבעט	הסבֿ־בעט
העסעך־האַדאַאַס	היסח־הדעת
העספּיידים	הספּדים
העספּעד	הספּד
העסקעם	הסכּם
העסקעמס	הסכּמס
העסקעם־קולעם	הסכּם־כּולם
העפֿסיידים	הפֿסדים
העפֿסייקים	הפֿסקים
העפֿסעד	הפֿסד
העפֿסעד־מערובע	הפֿסד־מרובה
העפֿסעק	הפֿסק
העפֿעך	הפֿך
העפֿקיירעס	הפֿקרות
העפֿקער	הפֿקר
העצאָע	הוצאה
העצאָעס	הוצאָות
העקייפֿים	היקפֿים
העקעף	היקף
הערגיילים	הרגלים
הערגל	הרגל
הערגל נאַאַסע טעווע	הרגל נעשׂה טבֿע
הערגל נײַסע טעווע	הרגל נעשׂה טבֿע
הערעג	הרג
הערעף־אַיִן	הרף־עין
העשײַנע	הושענא
העשײַנעס	הושענות
וו…	ו…
וואַאַד	וועד
וואַאַד־אַרבאַ־אַראָצעס	וועד־אַרבע־אַרצות
וואַדים	וועדים
וואָוו	ו
וואָוו	וואָוו
וואַטראָנים	וותּרנים
וואַטראָנעס	וותּרנות
וואַטרען	וותּרן
וואַטרענטע	וותּרנטע
וואַיאָווע האָמען	ויבֿוא המן
וואַיאָכלו	ויאכלו
וואַיאַצמעך־פּורקאָנע	ויצמח־פּורקניה
וואַיאַקהעל	ויקהל
וואַייִגעש	ויגש
וואַייִוורעך	ויבֿרח
וואַייילעך	וילך
וואַיייצע	ויצא
וואַייירע	וירא
וואַייישעוו	וישבֿ
וואַייִקראָ	ויקראָ
וואָיירע	וארא
וואַייִשלעך	וישלח
וואַיִכעד־ייִסרעדיק	ויחד־יתרודיק
וואַיִסרויצעצו	ויתרוצצו
וואַיעכי	ויחי
וואַיִצאַקו	ויצעקו
וואָסיקים	וותיקים
וואָסיקן	וותיקין
וואָסעק	וותיק
וואָעסכאַנען	ואתחנן
וואַשטע	ושתּי
וואַשטעס	ושתּיס
וואַשטען	ושתּין
וודאָק	ודו״ק
וווּראַכעם	והוא־רחום
ווידויִם	ווידויים
ווידע	ווידוי
ווידערקאָל	ווידערקול
ווידערקוילעס	ווידערקולות
וויטורים	וויתּורים
וויטער	וויתּור
ווייאָדער	ואָדר
ווײַהי	ויהי
ווײַהי האַיוים	ויהי היום
ווײַהי ראָצן	ויהי רצון
ווײַזאָסע	ויזתא
ווייס	בֿית
ווייציטקאָסכע	וצדקתך
וויישעט	וושט
וויקוכים	וויכּוחים
וויקועך	וויכּוח
וולאַד	וולד
וולאַדן	וולדן
ווע…	ו…
וועאָהאַווטאָ לערעיאַכאָ קאָמויכאָ	ואָהבֿתּ לרעך כּמוך
וועאַל־קולעם	ועל־כּולם
וועדײַ לאַכקימע בירמיזע	ודי לחכּימא ברמיזא
וועדײַ לאַמייוון	ודי למבֿין
וועדײַ לאַנאָוון	ודי לנבֿון
וועדײַעק וועסימצע קאַל	ודו״ק
וועדײַעק וועסימצע קאַל	ודייק ותמצא קל
וועהאַיעלעד איינענו	והילד איננו
וועהאָ־רײַע	והאָ־ראַיה
וועהאַשיינעס	והשנית
וועהײַעם	והיום
וועזויס־האַבראָכע	וזאת־הברכה
וועיינענו	ואיננו
וועכאָרעס	וכרות
ווענאָסנו	ונתנו
וועסט	ווסתּ
וועסטן	ווסתּן
וועקעדוימע	וכּדומה
זאָהאָוו	זהבֿ
זאָהעוו	זהובֿ
זאָהעוו־טאָהער	זהבֿ־טהור
זאָהער־וועזאָהער	זהיר־וזהיר
זאָווים	זבֿים
זאָכיִעס	זכיות
זאָכיִעסן	זכיותן
זאָכער	זכר
זאַכרעס	זכרות
זאַל	ז״ל
זאָל	זול
זאַלמען	זלמן
זאָנעוו	זנבֿ
זאַצאַל	זצ״ל
זאָקן	זקן
זאָקן־וועראָגל	זקן־ורגיל
זאָרעך	זרח
זאָרעכס	זרחס
זאָרעכן	זרחן
זאַרקען	זרקען
זגולע	סגולה
זגולעס	סגולות
זוגאָסוי	זוגתו
זוגאָסי	זוגתי
זוגאָסכע	זוגתך
זוגעס	זוגות
זוואָכים	זבֿחים
זוווּלן	זבֿולן
זוי טויראָ וועזוי סכאָראָ	זו תּורה וזו שׂכרה
זויכע	זוכה
זויכע־בעגוירל	זוכה־בגורל
זוילעל	זולל
זוילעל־וועסויווע	זולל־וסובֿא
זוילעל־וועסויוועניק	זולל־וסובֿאניק
זוינע	זונה
זוינעס	זונות
זויס־כאַנוקע	זאת־חנוכּה
זויער	זוהר
זיוו־האַשכינע	זיוו־השכינה
זיוווּגים	זיווגים
זיוועג	זיווג
זייוו	זאבֿ
זייכער	זכר
זייכער־לעכורבם	זכר־לחורבן
זייכער צאַדיק לעווראָכע	זכר צדיק לבֿרכה
זײַען	ז
זײַען	זיין
זיכרוינאָם לעווראָכע	זכרונם לבֿרכה
זיכרוינע לעווראָכע	זכרונה לבֿרכה
זיכרוינע לעווראָכע	זכרונו לבֿרכה
זיכרוינעס	זכרונות
זילזולים	זילזולים
זילזל	זילזול
זילפּע	זילפּה
זיקאָרן	זכּרון
זיקנע	זיקנה
זיקנע	זקנה
זכאָרים	זכרים
זכאַריע	זכריה
זכויר־בריס	זכור־ברית
זכוס 	זכות
זכוסן	זכותן
זכוסים	זכותים
זכוס־אָוועס	זכות־אָבֿות
זכוס־אַצמע	זכות־עצמו
זכוס־האַקיִעם	זכות־הקיום
זכוסע יאָגן	זכותו יגן
זכוסע יאָגן אָליינו	זכותו יגן עלינו
זכוסעם יאָגן	זכותם יגן
זכוסעם יאָגן אָליינו	זכותם יגן עלינו
זכיִע	זכיה
זכיִעס	זכיות
זמאַן	זמן
זמאַן־סימכעסיינע	זמן־שׂימחתנו
זמאַנים	זמנים
זמירעס	זמירות
זנאָווים	זנבֿים
זנוס	זנות
זע בעכוי וועזע בעכוי	זה בכה וזה בכה
זע בעקוי וועזע בעקוי	זה בכּה וזה בכּה
זע־האָרעגע	זה־הרגע
זעהוּווים	זהובֿים
זעהירעס	זהירות
זעמער	זמר
זע נויפֿל וועזע קאָם	זה נופֿל וזה קם
זערע	זרע
זערעש	זרש
זקאָנים	זקנים
זקאָנע	זקנה
זקיינים	זקנים
זקיינע	זקנה
זראָיִם	זרעים
זרובאָוול	זרובבֿל
זריִע	זריעה
טאַבאַאַס־האַמאַלכעס	טבעת־המלכות
טאַבאַאַס־קדושן	טבעת־קידושין
טאַבאַאַס־קידושן	טבעת־קידושין
טאַבור־האָאָרעץ	טבור־האָרץ
טאַג	תּג
טאַגן	תּגין
טאָהער	טהור
טאַז	ט״ז
טאַזריִע	תּזריע
טאַזריִע־מעצוירע	תּזריע־מצורע
טאָיאַנים	טוענים
טאָך	תּוך
טאָך	תּוך־
טאַכבולע	תּחבולה
טאַכטוינים	תּחתּונים
טאַכטוינימלעך	תּחתּונימלעך
טאַכלויִם־ראָיִם	תּחלואים־רעים
טאַכלייסים	תּכליתים
טאַכלעס	תּכלית
טאַכלעס־סינע	תּכלית־שׂינאה
טאַכנונים	תּחנונים
טאַכנע	תּנחום
טאַכנען	תּחנון
טאַכסיסע־מילכאָמע	תּכסיסי־מלחמה
טאָכעס	תּחת
טאָך־קאָלהאַטויכעס	תּוך־כּל־התּוכות
טאָך־קעדיידיבער	תּוך־כּדי־דיבור
טאַכריכים	תּכריכים
טאַכריכים־שטעך	תּכריכים־שטעך
טאַכשיטים	תּכשיטים
טאַכשיטן	תּכשיטין
טאַכשעט	תּכשיט
טאַל	טל
טאַל־אומאָטער	טל־ומטר
טאָלדעס	תּולדות
טאַל־וועמאָטער	טל־ומטר
טאַליאָנים	תּלינים
טאַלייסים	טליתים
טאַלייסים־קטאַנים	טליתים־קטנים
טאַליען	תּלין
טאַלמוד	תּלמוד
טאַלמוד־באַוולי	תּלמוד־בבֿלי
טאַלמוד־יערושאַלמי	תּלמוד־ירושלמי
טאַלמידים	תּלמידים
טאַלמידים־מוּוואָקים	תּלמידים־מובֿהקים
טאַלמידע	תּלמידה
טאַלמידע־כאַכאָמים	תּלמידי־חכמים
טאַלמעד	תּלמיד
טאַלמעד־כאָכעם	תּלמיד־חכם
טאַלמעד־מוּוועק	תּלמיד־מובֿהק
טאַלמעטוירע	תּלמוד־תּורה
טאָלע	טלה
טאָלע	תּלוי
טאָלע־בעדאָווער	תּלוי־בדבֿר
טאַלעס	טלית
טאַלעס־קאָטן	טלית־קטן
טאַם	טעם
טאַם	תּם
טאַמאַרע	תּמרה
טאַם־ווענישלעם	תּם־ונישלם
טאַם־ווענישלעם	תּם־ונשלם
טאָמע	טמא
טאָמעד	תּמיד
טאַמעוואַטע	תּמעוואַטע
טאַמעז	תּמוז
טאַמען	תּמען
טאָמעניק	טמאניק
טאָמער	תּמר
טאַמצייסים	תּמציתים
טאַמצעס	תּמצית
טאַנאָיִם	תּנאָים
טאַנאַך	תּנך
טאַנאַך	תּנ״ך
טאַנאַכיש	תּנכיש
טאַנאַצבע	תּנצב״ה
טאָנו ראַבאָנאָן	תּנו רבנן
טאַנייסים	תּעניתים
טאַנכעם	תּנחום
טאַנע	תּנא
טאַנעבאַרע	תּנא־ברא
טאָנעס	תּענית
טאַנעס־טשוּווע	תּענית־תּשובֿה
טאַנעס־ציבער	תּענית־ציבור
טאָעס	טעות
טאָעסן	טעותן
טאָעס־האַטפֿוס	טעות־הדפֿוס
טאָף	תּ
טאָף	תּוו
טאָפֿל	טפֿל
טאַפֿסאָנים	תּפֿסנים
טאַפֿסן	תּפֿסן
טאַפֿסען	תּפֿסען
טאַפֿסענען	תּפֿסענען
טאָפֿעס	תּפֿוס
טאַק	תּ״ק
טאַקאָנע	תּקנה
טאַקאָנעס	תּקנות
טאַקעף	תּקיף
טאַקעף־בעדאַטע	תּקיף־בדעתּו
טאַרבוט־שול	תּרבות־שול
טאַרבוט־שול	תּרבותּ־שול
טאַרבוס־שול	תּרבות־שול
טאַרבעס	תּרבות
טאַרגעם	תּרגום
טאַרגעם־אונקלעס	תּרגום־אונקלוס
טאַרגעם־האַשיווים	תּרגום־השיבֿעים
טאַרגעם־יוינעסן	תּרגום־יונתן
טאַרגעם־לאָשן	תּרגום־לשון
טאַרגעם־שייני	תּרגום־שני
טאַרומעס	תּרעומות
טאַרטע־דעסאַסרע	תּרתּי־דסתרי
טאַריאַג מיצוועס	תּרי״ג מיצוות
טאַרנעגוילים	תּרנגולים
טאַרנעגל	תּרנגול
טאַרע	טהרה
טאַרע־ברעט	טהרה־ברעט
טאָרעד	טרוד
טאַרעס	טהרות
טאַרעס־האַמישפּאָכע	טהרת־המשפּחה
טאַרע־שטיבל	טהרה־שטיבל
טאַרפּאַט	תּרפּ״ט
טאַרפּאַט אַלאָפֿים	תּרפּ״ט אַלפֿים
טאַרפֿעס	טרפֿות
טאַשלעך	תּשליך
טאַשמישע־קדושע	תּשמישי־קדושה
טאַשמעש	תּשמיש
טאַשמעש־האַמיטע	תּשמיש־המיטה
טאַשראַק	תּשר״ק
טהאָם	תּהום
טהאָמען	תּהומען
טהאָרעס	טהרות
טו	ט״ו
טו בישוואַט	ט״ו בשבֿט
טוּוויי־האָיִר	טובֿי־העיר
טוּוויע	טובֿיה
טוּוויעס	טובֿיהס
טוּוויען	טובֿיהן
טוווּל־יאָם	טבֿול־יום
טוווּנע	תּבֿונה
טוווּע	תּבֿואה
טוווּעס	תּבֿואות
טווילע	טבֿילה
טוויִע	תּבֿיעה
טוויִעס	תּבֿיעות
טוויִעס־אַיִן	טבֿיעות־עין
טוויִעס־אַיִן	טבֿיעת־עין
טוועריע	טבֿריה
טויגער	תּוגר
טויוואַאַס־בעפּע	תּובֿעת־בפּה
טויו־וואָווויו	תּוהו־ובֿוהו
טויווייע	תּובֿע
טויווייע־בעפּע	תּובֿע־בפּה
טויווים	תּובֿעים
טויוויע	טובֿיה
טויוול	טובֿל
טויוולען	טובֿלען
טויווע	טובֿה
טויוועס	טובֿות
טויוועס־האַנאָע	טובֿת־הנאה
טויוועס־האַקלאַל	טובֿת־הכּלל
טויכן	תּוכן
טויכן־האָיִניאָנים	תּוכן־הענינים
טויכעכע	תּוכחה
טוימים	תּאומים
טויסעפֿעס	תּוספֿות
טויע	טועה
טויעווויע	תּוהו־ובֿוהו
טויעם	טועם
טויעם־טאַם	טועם־טעם
טויען	טוען
טויפֿעס	תּופֿס
טוירע	תּורה
טוירע אוגדולע בעמאָקעם עכעד	תּורה וגדולה במקום אחד
טוירעס־כאַיִם	תּורת־חיים
טוירעס־לאָקשן	תּורת־לאָקשן
טוירעס־מוישע	תּורת־משה
טוירעס־מוישע עמעס	תּורת־משה אמת
טוירע־קולע	תּורה־כּולה
טוירע־שעבאַלפּע	תּורה־שבעל־פּה
טוירע־שעביקסאַוו	תּורה־שבכּתבֿ
טוישאָווים	תּושבֿים
טוישווים	תּושבֿים
טוישעוו	תּושבֿ
טומטעם	טומטום
טומע	טומאה
טיוויעס	טיבֿיעות
טיטעס האַראָשע	טיטוס הרשע
טײַווע	תּאווה
טײַוועס	תּאוות
טייווע	תּבֿה
טייוועס	תּבֿות
טייוועס	טבֿת
טײַמים	טעמים
טיימען	תּימן
טײַנוגים	תּענוגים
טײַנע	טענה
טײַנעס	טענות
טײַנע־אומײַנע	טענה־ומענה
טײַנעג	תּענוג
טײַנען	טענהן
טײַנעסט	טענהסט
טײַנעסטו	טענהסטו
טײַנעט	טענהט
געטײַנעט	געטענהט
טײַנעס־אוטוויִעס	טענות־ותּבֿיעות
טייקו	תּיקו
טייקעף	תּיכּף
טייקעף־אומיִיאַד	תּיכּף־ומיד
טיכיע	תּחיה
טילטל־האַדערעך	טילטול־הדרך
טילים	תּהילים
טימכע	תּימחה
טימכעס	תּימחהס
טינויפֿעס	טינופֿת
טינויקעס	תּינוקות
טינויקעסל	תּינוקתל
טינויקעס־שעל־בייסראַבאָן	תּינוקות־של־בית־רבן
טינעף	טינוף
טינעק	תּינוק
טיסכאַדעש	תּתחדש
טיפּע	טיפּה
טיפּע־מין־האַיאַם	טיפּה־מן־הים
טיפּע־סרוכע	טיפּה־סרוחה
טיפּעש	טיפּש
טיפּשים	טיפּשים
טיפּשע	טיפּשה
טיפּשעס	טיפּשות
טיפֿלע	תּיפֿלה
טיפֿערעס	תּפֿארת
טיקונים	תּיקונים
טיקונע־זויער	תּיקוני־זוהר
טיקן	תּיקון
טיקן־טאָעס	תּיקון־טעות
טיקן־כצאָס	תּיקון־חצות
טיקן־לייל־שוווּעס	תּיקון־ליל־שבֿועות
טיקן־שוווּעס	תּיקון־שבֿועות
טירדע	טירדה
טירופֿים	טירופֿים
טירכע	טירחא
טירכע	טירחה
טירעף	טירוף
טירעף־האַדאַס	טירוף־הדעת
טישבאָכעס	תּשבחות
טישבוירעס	תּשבורת
טישבי	תּישבי
טישים	תּישעים
טישע	תּישעה
טישעבאָוו	תּישעה־באָבֿ
טישרע	תּישרי
טכאַק	דחק
טכום	תּחום
טכום־האַמוישעוו	תּחום־המושבֿ
טכום־שאַבעס	תּחום־שבת
טכונע	תּכונה
טכיילעס	תּכלת
טכילעס	תּחילת
טכינע	תּחינה
טכינעס	תּחינות
טכיִעס־המייסים	תּחית־המתים
טליִע	תּליה
טלע	טלה
טמונעס־אָס	תּמונת־אות
טמורע	תּמורה
טמיכע	תּמיכה
טמימעס	תּמימות
טמיִע	תּמיה
טמעיִם	טמאים
טנאָיִם	תּנאָים
טנוע	תּנועה
טנועס	תּנועות
טנײַ	תּנאַי
טנײַ־געט	תּנאַי־גט
טעהוירים	טהורים
טעהי נישמאָסע צרורע ביצרויר האַכאַיִם	תּהי נשמתה צרורה בצרור החיים
טעהי נישמאָסע צרורע ביצרויר האַכאַיִם	תּהי נשמתו צרורה בצרור החיים
טעוויע	טבֿיה
טעווע	טבֿע
טעוסים	טעותים
טעכעסל	תּחתל
טעכעסער	תּחתער
טעל	תּל
טעלאַוויוו	תּל־אָבֿיבֿ
טעלאַוויוו	תּל־אַבֿיבֿ
טעל־אוילעם	תּל־עולם
טענאַך	תּנך
טענאַך	תּנ״ך
טענאַצווע	תּנצב״ה
טעס	ט
טעס	טית
טעפֿעך	טפֿח
טעצאַווע	תּצוה
טעקאָלע	תּקלה
טעראַך	תּרח
טערוצים	תּירוצים
טערעכטע	תּרחטע
טערעץ	תּירוץ
טערעץ־מאַספּיק	תּירוץ־מספּיק
טפֿאָכים	טפֿחים
טפֿוצעס־האָאָרעץ	תּפֿוצות־האָרץ
טפֿוצעס־ייִסראָעל	תּפֿוצות־ישׂראל
טפֿיילים	טפֿלים
טפֿילן	תּפֿילין
טפֿילע	תּפֿילה
טפֿילעס	תּפֿילות
טפֿילע־בעציבער	תּפֿילה־בציבור
טפֿילע־זאַקע	תּפֿילה־זכּה
טפֿילעס־האַדערעך	תּפֿילת־הדרך
טפֿיסע	תּפֿיסה
טפֿיסעס	תּפֿיסות
טפֿיסעניק	תּפֿיסהניק
טקומע	תּקומה
טקופֿע	תּקופֿה
טקופֿעס	תּקופֿות
טקופֿעס־טאַמעז	תּקופֿת־תּמוז
טקופֿעס־טייוועס	תּקופֿת־טבֿת
טקופֿעס־טישרע	תּקופֿת־תּישרי
טקופֿעס־ניסן	תּקופֿת־ניסן
טקיִע	תּקיעה
טקיִעס	תּקיעות
טקיִע־גדוילע	תּקיעה־גדולה
טקיִעס־קאַף	תּקיעת־כּף
טקיפֿים	תּקיפֿים
טקיפֿעס	תּקיפֿות
טרודים	טרודים
טרומע	תּרומה
טרומעס	תּרומות
טרוע	תּרועה
טרועס	תּרועות
טרופֿע	תּרופֿה
טרופֿעס	תּרופֿות
טרייף	טריף
טרייף־פּאָסל	טריף־פּסול
טרייפֿניאַק	טריפֿניאַק
טרייפֿע	טריפֿה
טרייפֿע	טרפֿה
טרייפֿעניצע	טריפֿהניצע
טרייפֿענע	טריפֿנע
טרייפֿענעם	טריפֿנעם
טרייפֿענער	טריפֿנער
טשאָיִם־וואַסאָווים	דשאָים־ועשׂבֿים
טשוּווע	תּשובֿה
טשוּוועס	תּשובֿות
טשוּווע־ברורע	תּשובֿה־ברורה
טשועס־כיין	תּשואות־חן
טשוקע	תּשוקה
טשוקעס	תּשוקות
יאַאַדעס	יהדות
יאַאַמויד	יעמוד
יאַבאָשע	יבשה
יאַבאָשעס	יבשות
יאַבעבאָ	יבבה
יאָגן־וואַאַנאָכע	יגון־ואַנחה
יאַד	יד
יאָדאַיִם	ידים
יאַדאַכעס	יד־אַחת
יאַדאָנים	ידענים
יאַדאָנעס	ידענות
יאַד־האַכאַזאָקע	יד־החזקה
יאָדים	יודעים
יאַדן	ידען
יאָדע־כיין	יודע־חן
יאָדע־נאַגיין	יודע־נגן
יאָדע־סייפֿער	יודע־ספֿר
יאָוון	יוון
יאַוונע	יבֿנה
יאָווע יוימע	יבֿוא יומו
יאַיִן	יין
יאַיִן־האַמשומער	יין־המשומר
יאַיִן־נעסעך	יין־נסך
יאַיִן־סאָרעף	יין־שׂרף
יאַיִן־קאַפֿריסן	יין־קפֿריסין
יאַכאַלויקו	יחלוקו
יאַכדעוו	יחדיו
יאָכוועט	יוכבֿד
יאָכלוהו	יאכלוהו
יאָכלען	יכלען
יאָכל	יכל
יאָכלסט	יכלסט
יאָכלסטו	יכלסטו
יאָכלט	יכלט
געיאָכלט	געיכלט
יאָכלען	יכולען
יאָכל	יכול
יאָכלסט	יכולסט
יאָכלסטו	יכולסטו
יאָכלט	יכולט
געיאָכלט	געיכולט
יאַכסאָנים	יחסנים
יאַכסאָנעס	יחסנות
יאַכסן	יחסן
יאַכסנטע	יחסנטע
יאַכסענען	יחסנען
יאָכעד	יחיד
יאָכעד־בעדאָר	יחיד־בדור
יאָכעד־בעמינע	יחיד־במינו
יאָכעוועד	יוכבֿד
יאָכעוועדס	יוכבֿדס
יאָכעוועדן	יוכבֿדן
יאָכפֿעט	יוכבֿד
יאָכפֿעטס	יוכבֿדס
יאָכפֿעטן	יוכבֿדן
יאָלדעס	יולדת
יאַלקוטים	ילקוטים
יאַלקעט	ילקוט
יאָם	יום
יאַם	ים
יאָם אַלעף	יום א׳
יאַם־אָקיאָנעס	ים־אוקינוס
יאָם בייס	יום ב׳
יאָם גימל	יום ג׳
יאָם דאַלעט	יום ד׳
יאַם־האַגאָדל	ים־הגדול
יאָם־האַדין	יום־הדין
יאַם־האַטיכוין	ים־התּיכון
יאַם־האַמעלאַך	ים־המלח
יאַם־האַקאָרעש	ים־הקרוש
יאַם־האַקעראַך	ים־הקרח
יאָם היי	יום ה׳
יאָם וואָוו	יום ו׳
יאָם־וואָלײַלע	יום־ולילה
יאָמים	ימים
יאַמען	ימען
יאַמים־אומידבאָריעס	ימים־ומידבריות
יאָמים־וועשאָנים	ימים־ושנים
יאָמים־טויווים	ימים־טובֿים
יאָמים־נעראָיִם	ימים־נוראָים
יאָמים־נעראָיִמדיק	ימים־נוראָימדיק
יאַם־כאַזיירימלעך	ים־חזירימלעך
יאַמכאַזערל	ים־חזירל
יאַמסוף	ים־סוף
יאָמקיפּער	יום־כּיפּור
יאָמקיפּער־קאָטן	יום־כּיפּור־קטן
יאַם שעל שלוימע	ים של שלמה
יאַנדעס	יהדות
יאָנטויווים	יום־טובֿים
יאָנטעוו	יום־טובֿ
יאָנטעוון	יום־טובֿן
יאָנטעוודיק	יום־טובֿדיק
יאָנטעוודיקער	יום־טובֿדיקער
יאָנטעוודיקן	יום־טובֿדיקן
יאָנטעוודיקע	יום־טובֿדיקע
יאָנטעוודיקס	יום־טובֿדיקס
יאָנקיפּער	יום־כּיפּור
יאָנקיפּער־קאָטן	יום־כּיפּור־קטן
יאַנקעוו	יעקבֿ
יאַנקעווס	יעקבֿס
יאַנקעוון	יעקבֿן
יאַנקעוו אָווינו	יעקבֿ אָבֿינו
יאַנקעוו אָווינוס	יעקבֿ אָבֿינוס
יאָסעם	יתום
יאָסעמדיק	יתומדיק
יאָסעף	יוסף
יאָסעפֿס	יוספֿס
יאָסעפֿן	יוספֿן
יאָסעף דעלע ריינע	יוסף דילה ריינה
יאָסעף האַצאַדיק	יוסף הצדיק
יאָסעף האַצאַדיקס	יוסף הצדיקס
יאָצע־מידאַטע	יצא־מדעתּו
יאָצרעס	יוצרות
יאַקיר	יקיר
יאַקנעהאָז	יקנה״ז
יאַקעקאָ	יכּכּה
יאַקראָנים	יקרנים
יאַקרען	יקרן
יאַקרעס	יקרות
יאָר־איידעס	יאָר־עדות
יאָרדים	יורדים
יאַרדן	ירדן
יאַריד	יריד
יאַרידן	ירידן
יאָרע־כעט	ירא־חטא
יאָרעם־הוידע	ירום־הודו
יאָרע־שאָמאַיִם	ירא־שמים
יאָרשים	יורשים
יאַרשען	ירשען
יאַרשענען	ירשענען
געיאַרשענט	געירשנט
יאַש	יש
יאַש	י״ש
יאָשווים	יושבֿים
יאָשווע־אויעל	יושבֿי־אוהל
יאָשן־נוישן	ישן־נושן
יאָשער	ישר
יאַשער־קויעך	יישר־כּוח
יאָשעש	ישיש
יאַשראָנים	ישרנים
יאַשראָנעס	ישרנות
יאַשרען	ישרן
יוד	י
יוד	יוד
יודיס	יהודית
יודעס	יהודית
יויוול	יובֿל
יויכענען	יוחנן
יויכענען בען־זאַקײַ	יוחנן בן־זכּאי
יוימע	יומא
יוימע־דעפּאַגרע	יומא־דפּגרא
יוימעם־וואָלײַלע	יומם־ולילה
יוינאָסן	יונתן
יוינאָסנס	יונתנס
יוינע	יונה
יוינעס	יונהס
יוינען	יונהן
יוינעסן	יונתן
יוינעסנס	יונתנס
יוינעק	יונק
יויסעף	יוסף
יויסעפֿס	יוספֿס
יויסעפֿן	יוספֿן
יויסעף דעלע ריינע	יוסף דילה ריינה
יויסעף האַצאַדיק	יוסף הצדיק
יויסעף האַצאַדיקס	יוסף הצדיקס
יויעל	יואל
יויעלס	יואלס
יויעלן	יואלן
יויעץ	יועץ
יויפֿע	יופֿי
יויצים־מין־האַקלאַל	יוצאים־מן־הכּלל
יויצע	יוצא
יויצע־דויפֿן	יוצא־דופֿן
יויצע־דויפֿנס	יוצא־דופֿנס
יויצע־וועניכנעס	יוצא־ונכנס
יויצע־מין־האַקלאַל	יוצא־מן־הכּלל
יויצע־מין־האַקלאַלן	יוצא־מן־הכּללן
יויצע־מיצראַיִם	יוצאי־מצרים
יויצער	יוצר
יויצער־מעשאָרסים	יוצר־משרתים
יויצער־מעשאָרסים וואַשער מעשאָרסאָוו	יוצר־משרתים ואשר משרתיו
יוירעד	יורד
יוירע־דייע	יורה־דעה
יוירעש	יורש
יוירעשטע	יורשטע
יוירעש־עצער	יורש־עצר
יוישעוו	יושבֿ
יוישעוו־אויעל	יושבֿ־אוהל
יוישעוו־ראָש	יושבֿ־ראָש
יוישער	יושר
ייִבעם	יבום
ייִגדאַל	יגדל
ייִטושים	ייִתּושים
ייִטער	ייִתּור
ייִטעש	ייִתּוש
יײַווער אָלײַ מאָ	יעבֿור עלי מה
יײַלע	יעלה
יײַלע־וועיאָווע	יעלה־ויבֿא
יייעש	ייִאוש
יייצער־האָרע	יצר־הרע
יייצער־טאָוו	יצר־טובֿ
יייצער־־טויוו	יצר־טובֿ
ייישו	ישו
ייישו האַנויצרי	ישו הנוצרי
ייישו האַנויצריס	ישו הנוצריס
ייִכודים	ייִחודים
ייִכיע	יחיה
ייִכעד	ייִחוד
ייִכעס	ייִחוס
ייִכעס־בריוו	ייִחוס־בריוו
ייִכעס־אַצמע	ייִחוס־עצמו
ייִכעסן	ייִחוסן
ייִמאַך־שמאָם	ימח־שמם
ייִמאַך־שמאָם־וועזיכראָם	ימח־שמם־וזכרם
ייִמאַך־שמוי	ימח־שמו
ייִמאַך־שמוי־וועזיכרוי	ימח־שמו־וזכרו
ייִמאַכשמויניצע	ימח־שמוניצע
ייִמאַכשמויניק	ימח־שמוניק
ייִמאַך־שעמאָם	ימח־שמם
ייִמאַך־שעמאָם־וועזיכראָם	ימח־שמם־וזכרם
ייִמאַך־שעמוי	ימח־שמו
ייִסאָכער	ישׂשׂכר
ייִסאָסכער	ישׂשׂכר
ייִסקער	יזכּור
ייִסקער־בוך	יזכּור־בוך
ייִסראָיילי	ישׂראלי
ייִסראָעל	ישׂראל
ייִסראָעלס	ישׂראלס
ייִסראָעלן	ישׂראלן
ייִסרוינעס	יתרונות
ייִסרע	יתרו
ייִסרעייליס	ישׂראלית
ייִסרען	יתרון
ייִעש	ייִאוש
ייִפֿטאַך	יפֿתּח
ייִצכאָק	יצחק
ייִצכאָקן	יצחקן
ייִצכאָקס	יצחקס
ייִצכאָק אָווינו	יצחק אָבֿינו
ייִצכאָק אָווינוס	יצחק אָבֿינוס
ייִצכאָקי	יצחקי
ייִרגאָזן	ירגזון
ייִרמיאָהו	ירמיהו
ייִרמיאָהוס	ירמיהוס
ייִרמיאָהון	ירמיהון
ייִרמיִע	ירמיהו
ייִרמיִעס	ירמיהוס
ייִרמיִען	ירמיהון
ייִרע	ייִראה
ייִרע־כעט	ירא־חטא
ייִרעס־האַקאָוועד	ייִראת־הכּבֿוד
ייִרעס־האַשעם	ייִראת־השם
ייִרעס־שאָמאַיִם	ייִראת־שמים
ייִרע־שאָמאַיִם	יראי־שמים
ייִשאָקייני	ישקני
ייִשו	ישו
ייִשו האַנויצרי	ישו הנוצרי
ייִשוּווים	ייִשובֿים
ייִשוּווניצע	ייִשובֿניצע
ייִשוּווניק	ייִשובֿניק
ייִשמאָעל	ישמעאל
ייִשעוו	ייִשובֿ
ייִשעוו־האַדאַאַס	ייִשובֿ־הדעת
ייִשעוון	ייִשובֿן
יעגיִעס־קאַפּאַיִם	יגיעת־כּפּים
יעגיִעס־קאַפּע	יגיעת־כּפּו
יעגיִעס־קאַפּעוו	יגיעת־כּפּיו
יעגיִע־קאַפּאַיִם	יגיע־כּפּים
יעגיִע־קאַפּאַיִמניק	יגיע־כּפּימניק
יעגיִע־קאַפּע	יגיע־כּפּו
יעגיִע־קאַפּעוו	יגיע־כּפּיו
יעדוע	ידוע
יעדוע־לאַקל	ידוע־לכּל
יעדיד	ידיד
יעדידי	ידידי
יעדידים־נעמאָנים	ידידים־נאמנים
יעדידיע	ידידיה
יעדיד־נעמען	ידיד־נאמן
יעדייע	יודע
יעדייע־האַקל	יודע־הכּל
יעדייע־כיין	יודע־חן
יעדייע־נאַגיין	יודע־נגן
יעדייע־סייפֿער	יודע־ספֿר
יעדייע־שעיינע־יעדייע	יודע־שאינו־יודע
יעדיִע	ידיעה
יעדיִעס	ידיעות
יעהודי	יהודי
יעהודיס	יהודית
יעהודע	יהודה
יעהודע האַכאָסיד	יהודה החסיד
יעהודע האַלייווי	יהודה הלווי
יעהודע האַמאַקאַבי	יהודה המכּבי
יעהודע האַנאָסי	יהודה הנשׂיא
יעהוינעסן	יהונתן
יעהויעש	יהואש
יעהוישוע	יהושע
יעהי	יהי
יעהי־אויר	יהי־אור
יעהי־ראָצן	יהי־רצון
יעוואָמעס	יבֿמות
יעוואָנים	יוונים
יעוואָניש	יווניש
יעוואָרעכעכאָ	יבֿרכך
יעכוילעס	יכולת
יעכידים	יחידים
יעכידע־זגולע	יחידי־סגולה
יעכיִעל	יחיאל
יעכעסקל	יחזקאל
יעכעסקלס	יחזקאלס
יעכעסקלען	יחזקאלן
יעלאָדים	ילדים
יעלאָלע	יללה
יעלאַמדיינע	ילמדנו
יעלוד־אישע	ילוד־אישה
יעלעד	ילד
יעלעד־שאַאַשויִם	ילד־שעשועים
יעמיי	ימי־
יענוקע	ינוקא
יעניקע	יניקה
יעסאָד	יסוד
יעסוידעס	יסודות
יעסוימים	יתומים
יעסוימימדיק	יתומימדיק
יעסוימימדיקער	יתומימדיקער
יעסוימימדיקע	יתומימדיקע
יעסוימימדיקן	יתומימדיקן
יעסוימימדיקס	יתומימדיקס
יעסוימע	יתומה
יעסורים	יסורים
יעסורים־ראָיִם	יסורים־רעים
יעסורים־שעל־אַאַווע	יסורים־של־אַהבֿה
יעסורים־שעל־אַהאַווע	יסורים־של־אַהבֿה
יעפֿאַסטויער	יפֿת־תּואר
יעפֿייפֿיִע	יפֿהפֿיה
יעפֿייפֿע	יפֿהפֿיה
יעפֿעס	יפֿת
יעציִעס־האַנעפֿעש	יציאת־הנפֿש
יעציִעס־מיצראַיִם	יציאת־מצרים
יעציִעס־נעשאָמע	יציאת־נשמה
יעצירע	יצירה
יעצירעס	יצירות
יעקאַר־האַמציִעס	יקר־המציאות
יעקום־פּורקאָן	יקום־פּורקן
יעקום־פּורקן	יקום־פּורקן
יעקוסיִעל	יקותיאל
יעקירי	יקירי
יעראָוואָם בען־נעוואָט	ירבֿעם בן־נבֿט
יעראַכמיִעל	ירחמיאל
יעראַכמיִעלס	ירחמיאלס
יעראַכמיִעלן	ירחמיאלן
יערוכעם	ירוחם
יערוכעמס	ירוחמס
יערוכעמען	ירוחמען
יערושאָלאַיִם	ירושלים
יערושאָלאַיִם־דע	ירושלים־ד…
יערושאָלאַיִם־דעליטע	ירושלים־דליטא
יערושאַלמי	ירושלמי
יערושע	ירושה
יערושעס	ירושות
יעריד	יריד
יערידע	ירידה
יעריכע	יריחו
יעריכעס	יריחוס
יעריִע	יריעה
יעריִעס	יריעות
יעש	יש
יעשאַיאָהו	ישעיהו
יעשאַיאָהו האַנאָווע	ישעיהו הנבֿיא
יעשאַיאָהו האַנאָוועס	ישעיהו הנבֿיאס
יעש אָמרים	יש אומרים
יעש־אָמרים	יש־אומרים
יעשוע	יהושע
יעשוע	ישועה
יעשועס	ישועות
יעשועס־ווענעכאָמעס	ישועות־ונחמות
יעשיווע	ישיבֿה
יעשיוועס	ישיבֿות
יעשײַע	ישעיה
יעשישים	ישישים
יעש־מעאַיִן	יש־מאַין
כאַבאַד	חב״ד
כאַבאַדניצע	חבדניצע
כאַבאַדניק	חבדניק
כאַבאַדער	חבדער
כאַגאָעס	חגאָות
כאַג־האָאָסיף	חג־האָסיף
כאַג־האַביקורים	חג־הביכּורים
כאַג־האַמאַצעס	חג־המצות
כאַגיגע	חגיגה
כאָגע	חגא
כאָגעס	חגות
כאַגע	חגי
כאַדאָרים	חדרים
כאַדאָרים־מעסוקאָנים	חדרים־מתוקנים
כאַדאָשים	חדשים
כאַדאָשעס	חדשות
כאַד־בעדאָרע	חד־בדרא
כאַד־גאַדיע	חד־גדיא
כאַדראַג	חדר״ג
כאַדרע־כאַדאָרים	חדרי־חדרים
כאַוווּרע	חבֿורה
כאַוווּרעס	חבֿורות
כאַוויירים	חבֿרים
כאַוויירים־לעדייע	חבֿרים־לדעה
כאַוויירע	חבֿרה
כאַווע	חווה
כאָוועווע־ספֿאַס־אייווער	חובֿבֿי־שׂפֿת־עבֿר
כאָוועווע־ציִען	חובֿבֿי־ציון
כאַוועס־דאַאַס	חוות־דעת
כאָווער	חבֿר
כאַווער	חבֿר
כאַווערטאָרן	חבֿרטאָרין
כאַווערטאָרנס	חבֿרטאָרינס
כאַווערטע	חבֿרטע
כאַוועריש	חבֿריש
כאַווער־לאַווער	חבֿר־לאַווער
כאַווערלאַפּ	חבֿר־לאַפּ
כאַווער־לעדייע	חבֿר־לדעה
כאַווערן	חבֿרן
כאַווערט	חבֿרט
כאַווערסט	חבֿרסט
כאַווערסטו	חבֿרסטו
געכאַווערט	געחבֿרט
כאַווערשאַפֿט	חבֿרשאַפֿט
כאַווקוק	חבֿקוק
כאַוורוסע	חבֿרותא
כאַוורוסעס	חבֿרותות
כאַזאַל	חז״ל
כאַזאָנים	חזנים
כאַזאָניש	חזניש
כאַזאָנעס	חזנות
כאַזאַק	חזק
כאַזאָקע	חזקה
כאַזאָרע	חזרה
כאַזאָרעס־האַשאַץ	חזרת־הש״ץ
כאַזיירים	חזירים
כאַזיירימלעך	חזירימלעך
כאַזן	חזן
כאַזנדל	חזנדל
כאַזאָנימלעך	חזנימלעך
כאַזנס	חזנס
כאַזנטע	חזנטע
כאַזנטעס	חזנטעס
כאַזער	חזיר
כאַזערל	חזירל
כאַזערטע	חזירטע
כאַזערטעס	חזירטעס
כאַזערײַ	חזירײַ
כאַזערײַען	חזירײַען
כאַזעריש	חזיריש
כאַזערישן	חזירישן
כאַזערישע	חזירישע
כאַזערישער	חזירישער
כאַזערן	חזרן
כאַזער	חזר
כאַזערסט	חזרסט
כאַזערט	חזרט
געכאַזערט	געחזרט
כאַזערנדיק	חזרנדיק
כאַזערניצע	חזירניצע
כאַזערניצעס	חזירניצעס
כאַזערניק	חזירניק
כאַזערניקעס	חזירניקעס
כאָזרים	חוזרים
כאָזרים־ביטשוּווע	חוזרים־בתּשובֿה
כאַטאָיִם	חטאָים
כאָטאָסי	חטאָתי
כאָטים	חוטאים
כאַטעס־נעורים	חטאת־נעורים
כאַטעף	חטף
כאַיאָווים	חייבֿים
כאַיאָטים	חייטים
כאַיאָלעס	חיילות
כאַיונע	חיונה
כאַיִל	חייל
כאַיִם	חיים
כאַיִמטע	חיימטע
כאַיִמס	חיימס
כאַיִמען	חיימען
כאַיעשאָ	חיי־שעה
כאַיִש	חייִש
כאַכאָמיינו זיכרוינעם לעווראָכע	חכמינו זכרונם לבֿרכה
כאַכאָמים	חכמים
כאַכאָמים־אַטיקים	חכמים־עתּיקים
כאַכאָמים־מופֿלאָגים	חכמים־מופֿלגים
כאַכאָמע	חכמה
כאַכיימעס	חכמת
כאָכמאַניס	חכמנית
כאָכמאַניִעס	חכמניות
כאָכמע	חכמה
כאָכמעס	חכמות
כאַכמע־האַטאַלמוד	חכמי־התּלמוד
כאַכמע־האַלעזשאַנקע	חכמי־הלעזשאַנקע
כאַכמע־ייִסראָעל	חכמי־ישׂראל
כאָכמע־כיצוינעס	חכמה־חיצונית
כאָכמע־ניסטערעס	חכמה־נסתּרת
כאָכמען	חכמהן
כאָכמענען	חכמהנען
כאָכמעס־	חכמת־
כאָכמעס־האַ…	חכמת־ה…
כאָכמעס־האַדאָקטאָריע	חכמת־הדאָקטאָריע
כאָכמעס־האַטכונע	חכמת־התּכונה
כאָכמעס־האַיאַאַדעס	חכמת־היהדות
כאָכמעס־האַיאַד	חכמת־היד
כאָכמעס־האַכעזשבם	חכמת־החשבון
כאָכמעס־האַכעזשבם־וועהאַמדידע	חכמת־החשבון־והמדידה
כאָכמעס־האַפּאַרצעף	חכמת־הפּרצוף
כאָכמעס־יאָוון	חכמת־יוון
כאָכמעס־כיצויניִעס	חכמות־חיצוניות
כאָכעם	חכם
כאָכעם־אַטעק	חכם־עתּיק
כאָכעם־באַלײַלע	חכם־בלילה
כאָכעם־לעהאָרע	חכם־להרע
כאָכעם־מופֿלעג	חכם־מופֿלג
כאַל	חל
כאַלאָיִם	חלאָים
כאַלאַס	חלאַת
כאַלאַסן	חלאַתן
כאַלאָפֿים	חלפֿים
כאַלאָקים	חלקים
כאַלאָשעס	חלשות
כאַלאָשעסדיק	חלשותדיק
כאַלוימעס	חלומות
כאַלוצים	חלוצים
כאַלוצע	חלוצה
כאַלוצעס	חלוצות
כאַלוקע	חלוקה
כאַלושים	חלושים
כאָלילע	חלילה
כאָלילע־וועכאַס	חלילה־וחס
כאָליען	חליען
כאַליצע	חליצה
כאַלע	חלה
כאָלעל	חלל
כאָלעם	חלום
כאַלעמויד	חול־המועד
כאַלעמוידיק	חול־המועדיק
כאַלעמוידיקער	חול־המועדיקער
כאַלעמוידיקע	חול־המועדיקע
כאַלעמוידיקן	חול־המועדיקן
כאַלעמוידיקס	חול־המועדיקס
כאָלעמויד	חול־המועד
כאָלעמוידיק	חול־המועדיק
כאָלעמוידיקער	חול־המועדיקער
כאָלעמוידיקע	חול־המועדיקע
כאָלעמוידיקן	חול־המועדיקן
כאָלעמוידיקס	חול־המועדיקס
כאָלעמען	חלומען
כאָלעמסט	חלומסט
כאָלעמט	חלומט
געכאָלעמט	געחלומט
כאָלעמענדיק	חלומענדיק
כאַלעף	חלף
כאָלעץ	חלוץ
כאָלעש	חלוש
כאַלעשן	חלשן
כאַלעש	חלש
כאַלעשסט	חלשסט
כאַלעשט	חלשט
געכאַלעשט	געחלשט
כאַלעשנדיק	חלשנדיק
כאָלעש־רייע	חלוש־ריאה
כאַלפֿאָנים	חלפֿנים
כאַלפֿאָנעס	חלפֿנות
כאַלפֿן	חלפֿן
כאָלקים	חולקים
כאַם	חם
כאָמדע־מאָמען	חומדי־ממון
כאַמויער	חמור
כאַמויר	חמור
כאַמוירים	חמורים
כאַמויריש	חמוריש
כאַמישאָסער	חמישה־עשׂר
כאַמישאָסער בישוואַט	חמישה־עשׂר בשבֿט
כאַמישי	חמישי
כאַמישים	חמישים
כאַמישע כומשע־טוירע	חמישה חומשי־תּורה
כאָמעץ	חמץ
כאַמער	חמור
כאַמערייזל	חמור־אייזל
כאַנאַניע	חנניה
כאַנויך	חנוך
כאַנויכס	חנוכס
כאַנויכן	חנוכן
כאַנופֿע	חנופֿה
כאַנוקע	חנוכּה
כאַנוקעס־האַבאַיִס	חנוכּת־הבית
כאַנייפֿים	חנפֿים
כאַניפֿושניצע	חניפֿושניצע
כאַניפֿושניק	חניפֿושניק
כאַניפֿע	חניפֿה
כאַניפֿעניק	חניפֿהניק
כאַניפֿעסניצע	חניפֿותניצע
כאַניפֿעסניק	חניפֿותניק
כאַניקע	חנוכּה
כאָנע	חנא
כאָנעס	חנאס
כאָנען	חנאן
כאַנע	חנה
כאַנעס	חנהס
כאַנען	חנהן
כאַנעך	חנוך
כאַנעכן	חנוכן
כאַנעכס	חנוכס
כאָנען	חנן
כאָנענס	חננס
כאָנענען	חננען
כאַנפֿאָנים	חנפֿנים
כאָנפֿים	חונפֿים
כאַנפֿן	חנפֿן
כאַנפֿען	חנפֿען
כאַנפֿענען	חנפֿענען
כאַס	חס
כאָס	חס
כאַסאָדים	חסדים
כאַסאַן־דענאַן	חתן־דנן
כאַסאַן־האַיויוול	חתן־היובֿל
כאַסאַנים	חתנים
כאָס־דאַרגע	נחות־דרגא
כאַס־וועכאָלילע	חס־וחלילה
כאַס־וועשאָלעם	חס־ושלום
כאָסיד	חסיד
כאָסידקע	חסידקע
כאַסלערע	חאַסלערע
כאַסלערע	חתלורע
כאַסלערע	חתליערע
כאַסמען	חתמען
כאַסמעט	חתמעט
כאַסמענען	חתמענען
געכאַסמעט	געחתמעט
כאָסן	חתן
כאָסנס	חתנס
כאָסנמאָל	חתן־מאָל
כאָסן־באָכער	חתן־בחור
כאָסן־בריישעס	חתן־בראשית
כאָסן־דענאַן	חתן־דנן
כאָסן־טוירע	חתן־תּורה
כאָסנקאַלע	חתן־כּלה
כאָסעדל	חסידל
כאָסעך־באָנים	חשׂוך־בנים
כאָסעם־מאַטע	חתום־מטה
כאַסענע	חתונה
כאַסענעס	חתונות
כאָסער	חסר
כאָסער־דייע	חסר־דעה
כאָסער־דייעניק	חסר־דעהניק
כאָף	כף
כאָפֿני	חפֿני
כאַצאַר־האַמאַלכעס	חצר־המלכות
כאַצופֿים	חצופֿים
כאַצופֿע	חצופֿה
כאַציירעס	חצרים
כאַציירעס־מעלאָכים	חצרות־מלכים
כאַציפֿעס	חציפֿות
כאַציצע	חציצה
כאָצע	חצי
כאָצע־דאָווער	חצי־דבֿר
כאָצע־כוידעש	חצי־חודש
כאָצע־כינעם	חצי־חינם
כאָצע לי כאָצע לאָך	חצי לי חצי לך
כאָצעף	חצוף
כאָצעף־מעכוצעף	חצוף־מחוצף
כאָצער	חצר
כאָצע־שאַבעסל	חצי־שבתל
כאָצע שעלי וועכאָצע שעלאָך	חצי שלי וחצי שלך
כאָק	חוק
כאָק־וועלוי־יאַווער	חוק־ולא־יעבֿר
כאַקירע	חקירה
כאַקירעס	חקירות
כאַקירע־דרישע	חקירה־ודרישה
כאַקירע־וועדרישע	חקירה־ודרישה
כאַקירען	חקירהן
כאָקל	חוקל
כאָק־לעיִסראָעל	חוק־לישׂראל
כאַקראָנים	חקרנים
כאָקרים	חוכּרים
כאַקרען	חקרן
כאַקרענען	חקרנען
כאַראָטע	חרטה
כאַראָמים	חרמים
כאַראָמעס	חרמות
כאַרוווינע	חרבֿונה
כאַרויסעס	חרוסת
כאַרוצים	חרוצים
כאַרוצע	חרוצה
כאַרטומים	חרטומים
כאַריידים	חרדים
כאַריידיש	חרדיש
כאַריפֿים	חריפֿים
כאַריפֿעס	חריפֿות
כאָרן־אַף	חרון־אַף
כאָרעד	חרד
כאָרעוו	חרובֿ
כאָרעוו־ווענעכרעוו	חרובֿ־ונחרבֿ
כאַרעף	חריף
כאָרעץ	חרוץ
כאַרפּע	חרפּה
כאַרפּעס	חרפּות
כאַשודים	חשודים
כאַשוּווים	חשובֿים
כאַשיוועס	חשיבֿות
כאַשכעס	חשכות
כאַשמענאָיִם	חשמונאָים
כאָשעד	חשוד
כאָשעוו	חשובֿ
כוט־האַמשולעש	חוט־המשולש
כוט־האַשעדרע	חוט־השדרה
כוידעש	חודש
כויוו	חובֿ
כויוועוו־ציִען	חובֿבֿ־ציון
כויוועס־האַלוואָוועס	חובֿות־הלבֿבֿות
כויוועס	חובֿות
כויזים	חוזים
כויזע	חוזה
כויזעק	חוזק
כויזעקן	חוזקן
כויזער	חוזר
כויזער־ביטשוּווע	חוזר־בתּשובֿה
כויטים	חוטאים
כויטע	חוטא
כויטע־אומאַכטי	חוטא־ומחטיא
כויטע־אומאַכטי עס האָראַבים	חוטא־ומחטיא את הרבים
כויטע־בייגל	חוטא־בעגל
כויטע־בעייגל	חוטא־בעגל
כויטעם	חוטם
כויטען	חוטאן
כוילאַנעס	חולנית
כוילי־האַנעפֿעש	חולי־הנפֿש
כוילים	חולים
כוילים־מעסוקאָנים	חולים־מסוכּנים
כוילים־נויפֿלים	חולים־נופֿלים
כוילי־נויפֿלים	חולי־נופֿלים
כוילע	חולה
כוילעוואַטע	חולהוואַטע
כוילעם	חולם
כוילעם־נאָז	חולם־נאָז
כוילע־מעסוקן	חולה־מסוכּן
כוילע־נויפֿל	חולה־נופֿל
כוילעק	חולק
כוימעד־מאָמען	חומד־ממון
כוימער	חומר
כוימער־היִולי	חומר־היולי
כוינעף	חונף
כויסעם	חותם
כויסעם־האַמאַלכעס	חותם־המלכות
כויקער	חוכּר
כויקער	חוקר
כויקער־וועדוירעש	חוקר־ודורש
כויקרים	חוקרים
כוירעש	חורש
כוישן	חושן
כוישן־מישפּעט	חושן־מישפּט
כוישעד	חושד
כוישעד־ביקשיירים	חושד־בכּשרים
כוישעך	חושך
כוישעך־וואַאַפֿיילע	חושך־ואַפֿלה
כוישעך־וואַכלאַקלאַקעס	חושך־וחלקלקות
כוישעך־מיצראַיִם	חושך־מצרים
כוישעכן	חושכן
כוכע־אוטלולע	חוכא־וטלולא
כוכע־טלולע	חוכא־טלולא
כולין	חולין
כולשע	חולשה
כומאָשים	חומשים
כומעש	חומש
כומרע	חומרא
כומרעס	חומרות
כופּע	חופּה
כופּעס	חופּות
כופּע־וועקדושן	חופּה־וקידושין
כופּע־וועקידושן	חופּה־וקידושין
כוץ	חוץ
כוץ־לאָאָרעץ	חוץ־לאָרץ
כוץ־לאַגעדער	חוץ־לגדר
כוץ־לאַמאַכנע	חוץ־למחנה
כוץ־לעדערעך־האַטעווע	חוץ־לדרך־הטבֿע
כוץ־לעזע	חוץ־לזה
כוצפּע	חוצפּה
כוצפּעניצע	חוצפּהניצע
כוצפּעניק	חוצפּהניק
כוקים	חוקים
כוקעס	חקת
כורבוינעס	חורבנות
כורבם	חורבן
כורבם־באַיִס־רישן	חורבן־בית־ראשון
כורבם־באַיִס־שייני	חורבן־בית־שני
כורבם־ליטעראַטור	חורבן־ליטעראַטור
כורבן	חורבן
כורבן־באַיִס־רישן	חורבן־בית־ראשון
כורבן־באַיִס־שייני	חורבן־בית־שני
כורבן־ליטעראַטור	חורבן־ליטעראַטור
כורווע	חורבֿה
כורוועס	חורבֿות
כוש	חוש
כוש־האַטאַם	חוש־הטעם
כוש־האַמישעש	חוש־המישוש
כוש־האַרייעך	חוש־הריח
כוש־האַריִע	חוש־הראיה
כוש־האַשמיִע	חוש־השמיעה
כושימדיק	חושימדיק
כושעם	חושים
כיבורים	חיבורים
כיבעט־האַקייווער	חיבוט־הקבֿר
כיבעס־ציִען	חיבת־ציון
כיבעק־ווענישעק	חיבוק־ונישוק
כיבער	חיבור
כידע	חידה
כידעס	חידות
כידודים	חידודים
כידושים	חידושים
כידושים־וועניפֿלאָעס	חידושים־ונפֿלאָות
כידושע־טוירע	חידושי־תּורה
כידעד	חידוד
כידעקל	חדקל
כידעש	חידוש
כידעשן	חידושן
געכידעשט	געחידושט
כיִוּווים	חיובֿים
כיזויען	חזיון
כיזוקים	חיזוקים
כיזיוינעס	חזיונות
כיזעק	חיזוק
כיטעך־האַדיבער	חיתּוך־הדיבור
כײַ	חי
כײַ	ח״י
כיידער	חדר
כיידער־ליפֿנים־מיכיידער	חדר־לפֿנים־מחדר
כיידער־מעיוכעד	חדר־מיוחד
כיידער־מעסוקן	חדר־מתוקן
כײַ־וועקײַעם	חי־וקים
כיילעוו	חלבֿ
כיילעוון	חלבֿן
כיילעק	חלק
כיילעק־לעוילעם־האַבע	חלק־לעולם־הבא
כיין	חן
כיין	ח״ן
כיין־גריבעלע	חן־גריבעלע
כיין־גריבעלעך	חן־גריבעלעך
כיינדל	חנדל
כיינדלעך	חנדלעך
כיינדלען	חנדלען
כיינעוודיק	חנעוודיק
כײַע	חיה
כײַע־אָדעם	חיי־אָדם
כײַע־אוילעם	חיי־עולם
כײַעוו	חייבֿ
כײַעוו־מיסע	חייבֿ־מיתה
כײַעט	חייט
כײַעס	חיות
כײַע־סאָרע	חיי־שׂרה
כײַע־ראָע	חיה־רעה
כייפֿעץ	חפֿץ
כיירעם	חרם
כיירעם־דעראַביינו־גערשאָם	חרם־דרבנו־גרשם
כיירעם־קוויטל	חרם־קוויטל
כיירעף־נעפֿעש	חרוף־נפֿש
כיירעש	חורש
כיירעש שויטע וועקאָטן	חרש שוטה וקטן
כיישעק	חשק
כילולים	חילולים
כילופֿים	חילופֿים
כילוקים	חילוקים
כילוקע־דייעס	חילוקי־דעות
כילעל	חילול
כילעל־האַטוירע	חילול־התּורה
כילעל־האַמעס	חילול־המת
כילעל־האַקאָוועד	חילול־הכּבֿוד
כילעל־האַקוידעש	חילול־הקודש
כילעל־האַשעם	חילול־השם
כילעל־קוידעש	חילול־קודש
כילעל־שאַבעס	חילול־שבת
כילעף	חילוף
כילעפֿן	חילופֿן
כילעק	חילוק
כינעך	חינוך
כינעך	חנוך
כיסער	חיסור
כיִעוו	חיובֿ
כיִעס	חיות
דאָס כיִעס	דאָס חיות
כיִעסן	חיותן
כיצוינים	חיצונים
כיצויניִעס	חיצוניות
כיצן	חיצון
כירעק	חיריק
כלושע־רייע	חלושי־ריאה
כליצע	חליצה
כמאָרים	חמרים
כמימע	חמימה
כמימעסדיק	חמימותדיק
כמישי	חמישי
כמישים	חמישים
כנופֿע	חנופֿה
כניפֿושניצע	חניפֿושניצע
כניפֿושניק	חניפֿושניק
כניפֿע	חניפֿה
כניפֿעלע	חניפֿהלע
כניפֿעלעך	חניפֿהלעך
כניפֿעס	חניפֿות
כניפֿעניק	חניפֿהניק
כניפֿעניקעס	חניפֿהניקעס
כניפֿעסניצע	חניפֿותניצע
כניפֿעסניצעס	חניפֿותניצעס
כניפֿעסניק	חניפֿותניק
כניפֿעסניקעס	חניפֿותניקעס
כסאָדים	חסדים
כסאַר־דייע	חסר־דעה
כסאַר־דייעש	חסר־דעהש
כסוכע־באָנים	חשׂוכי־בנים
כסומים־מאַטע	חתומים־מטה
כסידאַרניע	חסידאַרניע
כסידאַרניעס	חסידאַרניעס
כסידים	חסידים
כסידיש	חסידיש
כסידישער	חסידישער
כסידישע	חסידישע
כסידישן	חסידישן
כסידע־אומעס־האָוילעם	חסידי־אומות־העולם
כסידע־אַשקענאַז	חסידי־אַשכּנז
כסידעס	חסידות
כסימע	חתימה
כסימעס	חתימות
כסימע־געלט	חתימה־געלט
כסימע־טויווע	חתימה־טובֿה
כסימעס־זאָקן	חתימת־זקן
כעדווע	חדווה
כעוולע־יעצירע	חבֿלי־יצירה
כעוולע־ליידע	חבֿלי־לידה
כעוולע־מעשיִעך	חבֿלי־משיח
כעוורײַע	חבֿרייא
כעוורײַע	חבֿריה
כעוורע	חבֿרה
כעוורעס	חבֿרות
כעוורעמאַן	חבֿרה־מאַן
כעוורען	חבֿרון
כעוורעניק	חבֿרהניק
כעוורע־קעדישע	חבֿרה־קדישא
כעזשבוינעס	חשבונות
כעזשבם	חשבון
כעזשבם־האַנעפֿעש	חשבון־הנפֿש
כעזשבם־צעדעק	חשבון־צדק
כעזשבענען	חשבונען
כעזשוון	חשוון
כעט	חטא
כעלבנע	חלבנה
כענעק	חנק
כעס	ח
כעס	חית
כעסאָרן	חסרון
כעסאָרן־קיס	חסרון־כּיס
כעסעד	חסד
כעסעד־שעל־עמעס	חסד־של־אמת
כעסרוינים	חסרונים
כעסרוינעס	חסרונות
כעפֿצעס	חפֿצות
כעפֿצעס	חפֿציות
כפֿאָצים	חפֿצים
כפֿייצים	חפֿצים
כצאָס	חצות
כצופֿים	חצופֿים
כצופֿע	חצופֿה
כציירעס	חצרות
כציירעס־מעלאָכים	חצרות־מלכים
כציפֿעס	חציפֿות
כציצע	חציצה
כקירע	חקירה
כקירעס	חקירות
כקירע־דרישע	חקירה־ודרישה
כקירע־וועדרישע	חקירה־ודרישה
כקירען	חקירהן
כראָטע	חרטה
כראָטעס	חרטות
כראָמים	חרמים
כראָמעס	חרמות
כרויסעס	חרוסת
כריפֿים	חריפֿים
כריפֿעס	חריפֿות
כשאַד	חשד
כשאָדים	חשדים
כשאַש	חשש
כשאָשים	חששים
כשאַש־כאָמעץ	חשש־חמץ
כשאָשעס	חששות
כשודים	חשודים
כשוּווים	חשובֿים
כשיוועס	חשיבֿות
לאַ…	ל…
לאַג־בעוימער	ל״ג־בעומר
לאַהאַרעג־אולעאַבעד	להרוג־ולאַבד
לאַוו	לאַוו
לאַוו־דאַפֿקע	לאַוו־דווקא
לאָוון	לבֿן
לאָוון האָאַראַמי	לבֿן האַרמי
לאַזאָזל	לעזאזל
לאָט	לוט
לאַטכאָנים	לקחנים
לאַטכן	לקחן
אַרויסלאַטכענען	אַרויסלקחנען
אַרויסגעלאַטכנט	אַרויסגעלקחנט
לאַטכענען	לקחנען
לאַיעהודים	ליהודים
לאַכאָדים	לאַחדים
לאַכאָדימניצע	לאַחדימניצע
לאַכאָדימניצעס	לאַחדימניצעס
לאַכאָדימניק	לאַחדימניק
לאַכאָדימניקעס	לאַחדימניקעס
לאַכאַצאָיִם	לחצאָים
לאַכאַצאָיִן	לחצאָין
לאָכיין	לכן
לאַכלוטן	לחלוטין
לאַכמע	לחמא
לאָכן	לכן
לאַכעש	לחש
לאַמדאָנים	למדנים
לאַמדאָנעס	למדנות
לאָמדים	לומדים
לאָמדיש	לומדיש
לאַמדן	למדן
לאָמדעס	לומדות
לאַמעד	ל
לאַמעד	למד
לאַמעדוואָוו	למד־וואָוו
לאַמעד־וואָווניצע	למד־וואָווניצע
לאַמעד־וואָווניק	למד־וואָווניק
לאָעט	להוט
לאָער	להוט
לאַפּאַג	לפּ״ג
לאַפּאַק	לפּ״ק
לאַפֿוקע	לאַפֿוקי
לאָצן	לצון
לאַקכאָנים	לקחנים
לאַקכן	לקחן
לאַקכענען	לקחנען
לאַקל אייס	לכּל עת
לאָשן	לשון
לאָשן־האָרע	לשון־הרע
לאָשן־זאָכער	לשון־זכר
לאָשן־יאָכעד	לשון־יחיד
לאָשן־נעקייווע	לשון־נקבֿה
לאָשן־נעקיִע	לשון־נקיה
לאָשן־סעגינאָער	לשון־סגי־נהור
לאָשן־קוידעש	לשון־קודש
לאָשן־ראַבים	לשון־רבים
לוי	לא
לוי־אַלייכעם	לא־עליכם
לוי־אַלייכעמדיק	לא־עליכמדיק
לוי־אָליינו	לא־עלינו
לוי אַלמען ייִסראָעל	לא אַלמן ישׂראל
לוי דובים וועלוי יאַאַר	לא דובים ולא יער
לוי־דײַ	לא־די
לוי הויו דוואָרים מעוילעם	לא היו דבֿרים מעולם
לוי הויע וועלוי ניוורע	לא היה ולא ניבֿרא
לוי הוכשער דאָרע	לא הוכשר דרא
לויווים	לווים
לויווע	לווה
לויט	לוט
לוי־יוצלעך	לא־יוצלח
לוי ייִזאָכער וועלוי ייִפּאָקעד	לא יזכר ולא יפּקד
לוי ייִמאָלעט	לא ימלט
לוי־יעכרעץ	לא־יחרץ
לוי־יעכרעץ־געלט	לא־יחרץ־געלט
לוימערן	לומרן
לוי־סאַכמעד	לא־תחמוד
לוי־סיגנעוו	לא־תיגנובֿ
לויסײַסע	לא־תעשׂה
לוי־סינעף	לא־תינאף
לוי־סירצעך	לא־תירצח
לוי־־סערצעך	לא־תירצח
לויסעסע	לא־תעשׂה
לויעג־לעראָש	לועג־לרש
לויפֿידאַלטי	לא־פֿידלתּי
לוי פֿילאָלטי	לא פֿיללתּי
לוי־קאָלשעקען	לא־כּל־שכּן
לוי־קאָלשקען	לא־כּל־שכּן
לויקי	לא־כּי
לוכעס	לוחות
לולאָווים	לולבֿים
לולעוו	לולבֿ
לועך	לוח
לוריע	לוריא
לי…	ל…
ליבריִעס־האָוילעם	לבריאת־העולם
ליבריִעס־אוילעם	לבריאת־עולם
ליגנײַ	לגנאַי
לידיי גמאַר	לידי גמר
לידיי געמער	לידי גמר
לייווי	לווי
לייכעס	לחות
לייכעץ	לחות
לייל־האַשימורים	ליל־השימורים
ליילע־אוליילע	לעילא־ולעילא
ליילע־אוליילעדיק	לעילא־ולעילאדיק
לייל־שימורים	ליל־שימורים
ליימער	לאמר
ליימערן	לאמרן
לייע	לאה
לייעס	לאהס
לייען	לאהן
לייעלע	לאהלע
לייעלעס	לאהלעס
לייעלען	לאהלען
לייצים	לצים
ליכווויד	לכבֿוד
ליכוירע	לכאורה
ליכשעיאַרוויִעך	לכשירוויח
ליכשעיאַרכעוו	לכשירחיבֿ
ליליס	לילית
לימדינעס־האַיאַם	למדינת־הים
לימודים	לימודים
לימעד	לימוד
לינעס־האַצעדעק	לינת־הצדק
לינעס־צעדעק	לינת־צדק
ליסכוס	לזכות
ליִע	עליה
ליפּראַט־גאָדל	לפּרט־גדול
ליפּראַט־קאָטן	לפּרט־קטן
ליפֿנײַ־וועליפֿנים	לפֿני־ולפֿנים
ליפֿניי־קאָל־אַם־וועיידע	לפֿני־כּל־עם־ועדה
ליפֿנים־מעשורעס־האַדין	לפֿנים־משורת־הדין
ליצמיסעס	לצמיתות
ליקויִם	ליקויים
ליקע	ליקוי
ליקע־כאַמע	ליקוי־חמה
ליקע־לעוואָנע	ליקוי־לבֿנה
ליקשעיאַרוויִעך	לכּשירוויח
ליקשעיאַרכעוו	לכּשירחיבֿ
לישוואַך	לשבֿח
לישמאָ	לשמה
למײַ	הלמאַי
לע…	ל…
לעאַכער־האַמײַסע	לאַחר־המעשׂה
לעאַכער־זמאַן	לאַחר־זמן
לעאַכער־מייע־שאָנים	לאַחר־מאה־שנים
לעאָסעד	לעתיד
לעאָסעד־לאָווע	לעתיד־לבֿוא
לעגאַבע	לגבי
לעגאַמרע	לגמרי
לעגבוימער	ל״ג־בעומר
לעדאָר־דוירעס	לדור־דורות
לעדוגמע	לדוגמא
לעדוירעס	לדורות
לעהאַבע	להבא
לעהאַדאַם	להד״ם
לעהאַוודל	להבֿדיל
לעהאַוודל עלעף אַלפֿיי האַוודאָלעס	להבֿדיל אלף אַלפֿי הבֿדלות
לעהאַוודל עלעף האַוודאָלעס	להבֿדיל אלף הבֿדלות
לעהאַכעס	להכעיס
לעהאַכעסניצע	להכעיסניצע
לעהאַכעסניק	להכעיסניק
לעהאַשמיד־אולעהאַרעג	להשמיד־ולהרוג
לעהייפּעך	להיפּוך
לעוו	לבֿ
לעוואָוועס	לבֿבֿות
לעוואַטאָלע	לבֿטלה
לעוואָנע	לבֿנה
לעוואָנעס	לבֿנות
לעוואָנען	לבֿנון
לעוווּש	לבֿוש
לעוווּשן	לבֿושין
לעוווּשים	לבֿושים
לעווטאָוו	לבֿ־טובֿ
לעוויאָסן	לוויתן
לעוויִיִם	לוויים
לעווײַע	לוויה
לעווײַעס	לוויות
לעוו יעדייע	לבֿ יודע
לעוילאָמעס	לעולמות
לעוילעם	לעולם
לעוילעם־וואָעד	לעולם־ועד
לעוילעם טיקעך	לעולם תּיקח
לעוילעמעס	לעולמות
לעזייכער	לזכר
לעזייכער־אוילעם	לזכר־עולם
לעזיכרען־דוירעס	לזכרון־דורות
לעזיקאָרן	לזכּרון
לעטאַרבעס־ראָע	לתּרבות־רעה
לעטאַשמעש	לתּשמיש
לעטויווע	לטובֿה
לעטויוועס	לטובֿת
לעטויוועס־האַקלאַל	לטובֿת־הכּלל
לעטוירע לעכופּע אולמײַסים־טויווים	לתּורה לחופּה ולמעשׂים־טובֿים
לעיִבעד	לאיבוד
לעייווער־האַיאַם	לעבֿר־הים
לעיינע־האַשעמעש	לעיני־השמש
לעייס־זיקנע	לעת־זיקנה
לעיִניאָניינו	לעניננו
לעיעסער־ביטאָכן	ליתר־בטחון
לעיעסער־טויקעף	ליתר־תּוקף
לעיעסער־כיזעק	ליתר־חיזוק
לעכאָ־דוידי	לכה־דודי
לעכאַטכילע	לכתּחילה
לעכאַיִם	לחיים
לעכאַיִם־אולעשאָלעם	לחיים־ולשלום
לעכאַיִם־טויווים־אולעשאָלעם	לחיים־טובֿים־ולשלום
לעכאָלאַדייעס	לכל־הדעות
לעכאָלאַפּאָכעס	לכל־הפּחות
לעכאָשים	לחשים
לעכוד	לחוד
לעכו וועניילכאָ	לכו ונלכה
לעכויווע	לחובֿה
לעכו־נעראַנענאָ	לכו־נרננה
לעכלעכאָ	לך־לך
לעכעם	לחם
לעלאַאַג־אולקעלעס	ללעג־ולקלס
לעמאַזל	למזל
לעמאַנאַשעם	למען־השם
לעמאַן־האָעמעס	למען־האמת
לעמאַן־ייידו	למען־ידעו
לעמאַן־ייִשמעו־וועייִרו	למען־ישמעו־ויראו
לעמאַרעס־אַיִן	למראית־עין
לעמאָשל	למשל
לעמײַ	הלמאַי
לעמײַ	למאַי
לעמײַלע	למעלה
לעמײַלע־מין־האַטעווע	למעלה־מן־הטבֿע
לעמײַלע־מין־האַסייכל	למעלה־מן־השׂכל
לעמײַסע	למעשׂה
לעמיספּאָראָם	למיספּרם
לעמעהאַדרין	למהדרין
לעמעך	למך
לענוי	לנוי
לעסאַטע	לעת־עתּה
לעסאָף	לסוף
לעס בריירע	לית ברירה
לעס דין וועלעס דײַען	לית דין ולית דיין
לעסיירוגן	לסירוגין
לעערעך	לערך
לעפּאָכעס	לפּחות
לעפּאָנעם	לפּנים
לעפֿטאָוו	לבֿ־טובֿ
לעפֿי	לפֿי
לעפֿידאַטי	לפֿי־דעתּי
לעפֿיזע	לפֿי־זה
לעפֿי־טומע	לפֿי־תּומו
לעפֿי־מײַסעוו	לפֿי־מעשׂיו
לעפֿי־ערעך	לפֿי־ערך
לעפֿישאָ	לפֿי־שעה
לעפֿי־שאָעדיק	לפֿי־שעהדיק
לעץ	לץ
לעצאָנים	לצנים
לעצאָנעס	לצנות
לעצן	לצן
לעצעווען	לצעווען
לעקאָוועד	לכּבֿוד
לעקאַף־כויוו	לכּף־חובֿ
לעקאַף־סכוס	לכּף־זכות
לעראָוו	לרובֿ
לעראָע	לרעה
לעראָצן	לרצון
לעשאָנאָ האַבאָ בירושאָלאַיִם	לשנה הבאה בירושלים
לעשאָנע טויווע טיקאָסייוווּ	לשנה טובֿה תּכּתבֿו
לעשאָנע טויווע טיקאָסייוווּ וועסעכאָסיימו	לשנה טובֿה תּכּתבֿו ותחתמו
לעשוינעס	לשונות
לעשיטאָסע	לשיטתו
לעשעם	לשם
לעשעם־ייִכעד	לשם־ייִחוד
לעשעם־שאָמאַיִם	לשם־שמים
מאַ	מה
מאָ	מה
מאַאַמאַקים	מעמקים
מאָ אָנו אומע כאַייינע	מה אָנו ומה חיינו
מאַאַפּילים	מעפּילים
מאַאַרע	מערה
מאַבל	מבול
מאַבלען	מבולען
מאַבעקאַך	מה־בכּך
מאַגביל	מגביל
מאַגידים	מגידים
מאַגידעס	מגידות
מאַגיִיִם	מגיים
מאַגייפֿע	מגפֿה
מאַגייפֿעס	מגפֿות
מאַגיִע	מגיה
מאָגן־דאָוועד	מגן־דוד
מאָגן	מגן
מאַגעד	מגיד
מאַגעדקע	מגידקע
מאַגעמאַסע	מגע־ומשׂא
מאַגעמאַסע	מגע־משׂא
מאָדײַ	מדי
מאָדין	מודיעין
מאַדע	מדע
מאַדעך	מה־דאָך
מאַדרייגע	מדרגה
מאַדרייגעס	מדרגות
מאַדריכים	מדריכים
מאַדרעך	מדריך
מאַהאַר…	מהר…
מאַהאַראַל	מהר״ל
מאַהאַראַם	מהר״ם
מאַהאַרשאָ	מהרש״אָ
מאַהאַרשאַל	מהרש״ל
מאָויז־צור	מעוז־צור
מאַזאָלעס	מזלות
מאַזיקים	מזיקים
מאַזיקן	מזיקן
מאַזל	מזל
מאַזל אַקרעוו	מזל עקרבֿ
מאַזל אַריע	מזל אַריה
מאַזל־בראָכע	מזל־ברכה
מאַזל געדי	מזל גדי
מאַזל דאָגים	מזל דגים
מאַזל דעלי	מזל דלי
מאַזלטאָוו	מזל־טובֿ
מאַזל טאָלע	מזל טלה
מאַזל טוימים	מזל תּאומים
מאַזל מאָזנאַיִם	מזל מאָזנים
מאַזל סאַרטן	מזל סרטן
מאַזל פּסולע	מזל בתולה
מאַזל קאַשעס	מזל קשת
מאַזל שאָר	מזל שור
מאָזנאַיִם	מאָזנים
מאָזנאַיִם	מזל מאָזנים
מאַזעק	מזיק
מאַזער	מזהיר
מאַטאַמים	מטעמים
מאַטאָנע	מתּנה
מאַטאָנעס	מתּנות
מאַטבייע	מטבע
מאַטבייעס	מטבעות
מאַטויוו	מה־טובֿ
מאַטויווע	מה־טובֿו
מאַטיפֿים	מטיפֿים
מאַטיקים	מעתּיקים
מאַטכע	מדחה
מאַטמוינים	מטמונים
מאַטמען	מטמון
מאַטן־בעסייסער	מתּן־בסתר
מאַטן־טוירע	מתּן־תּורה
מאַטנעס־באָסער־וועדאָם	מתּנת־בשׂר־ודם
מאַטנעס־יאַד	מתּנת־יד
מאַטנעס־כינעם	מתּנת־חינם
מאַטנעס־עלויהים	מתּנת־אלוהים
מאַטנעס־עלויקים	מתּנת־אלוהים
מאַטע	מטה
מאַטעם	מטעים
מאַטע־מאַטע	מטה־מטה
מאַטע־־מאָטע	מטה־מטה
מאַטעס	מטות
מאַטעס	מתּת
מאַטעס־אומאַסע	מטות־ומסעי
מאַטעסיאָהו	מתּתיהו
מאַטעסיאָהוס	מתּתיהוס
מאַטעס־מאַסע	מטות־מסעי
מאַטעף	מטיף
מאַטער	מתּיר
מאַטער־דאַם	מתּיר־דם
מאַטער־ניידער	מתּיר־נדר
מאַטפּיסים	מדפּיסים
מאַטפּעס	מדפּיס
מאַטריִעך	מטריח
מאַטרעניסע	מטרוניתא
מאַיאָפֿעס	מה־יפֿית
מאַיאָפֿעס־ייִד	מה־יפֿית־ייִד
מאַיאָפֿעס־לידל	מה־יפֿית־לידל
מאַיאָפֿעסניק	מה־יפֿיתניק
מאַ־יאָקער	מה־יקר
מאַ־יויקער	מה־יוקר
מאַיײַסעניק	מה־יעשׂהניק
מאַיִם	מים
מאַיִם־אַכרוינים	מים־אַחרונים
מאַיִם־כאַיִם	מים־חיים
מאַיִם־שעיין־לאָהעם־סאָף	מים־שאין־להם־סוף
מאַיִם־שעלאָנו	מים־שלנו
מאַכבעד	מכביד
מאַכזאָקעס	מחזקות
מאַכזוירים	מחזורים
מאַכזיר־לעמוטעוו	מחזיר־למוטבֿ
מאַכזעק	מחזיק
מאַכזעק־טויווע	מחזיק־טובֿה
מאַכזער	מחזור
מאַכלויקע	מחלוקה
מאַכלויקעס	מחלוקת
מאַכלויקעסן	מחלוקתן
מאַכלויקעס	מחלוקות
מאַכלע	מחלה
מאַכלעס	מחלות
מאַכלעס באַס־נײַמע	מחלת בת־נעמה
מאַכמירים	מחמירים
מאַכמעדאַניש	מחמדאַניש
מאַכמעדאַנער	מחמדאַנער
מאַכמעס	מחמת
מאַכמעץ	מחמיץ
מאַכמער	מחמיר
מאַכניסע־אָרכים	מכניסי־אורחים
מאַכנע	מחנה
מאַכנעס	מחנות
מאַכנעס־אוירעך	מכניס־אורח
מאַכנעס־אוירעכטע	מכניס־אורחטע
מאַכנעסווײַז	מחנותווײַז
מאָכסים	מוכסים
מאָכע	מחה
מאַכעטאָנים	מחותּנים
מאַכעטאָנעשאַפֿט	מחותּנותשאַפֿט
מאַכעטענעסטע	מחותּנתטע
מאַכעטענעסטעס	מחותּנתטעס
מאָכרים	מוכרים
מאַכריִע	מכריע
מאַכרעוו	מחריבֿ
מאַכרעז	מכריז
מאַכרעז־אומוידיִע	מכריז־ומודיע
מאַכרעם	מחרים
מאַכרעם־אוילעם	מחרים־עולם
מאָכרע־ספֿאָרים	מוכרי־ספֿרים
מאַכשאָווע	מחשבֿה
מאַכשאָוועס	מחשבֿות
מאַכשאָווע־זאָרע	מחשבֿה־זרה
מאַכשאָווע־טויווע	מחשבֿה־טובֿה
מאַכשאָוועסן	מחשבֿותן
מאַכשאָווע־ראָע	מחשבֿה־רעה
מאַכשייפֿטע	מכשפֿטע
מאַכשייפֿע	מכשפֿה
מאַכשייפֿטע	מכשפֿהטע
מאַכשייפֿטעס	מכשפֿטעס
מאַכשייפֿעס	מכשפֿהס
מאַכשייפֿטעס	מכשפֿהטעס
מאַכשייפֿעס	מכשפֿות
מאַכשירים	מכשירים
מאַכשירין	מכשירין
מאַכשל	מכשיל
מאַכשער	מכשיר
מאַל	מל
מאַלאָכי	מלאָכי
מאַלאַכיי־האַשאָרעס	מלאַכי־השרת
מאַלאַכע־האַשאָלעם	מלאַכי־השלום
מאַלאַכע־כאַבאָלע	מלאַכי־חבלה
מאַלאַכע־עליען	מלאַכי־עליון
מאַלבושים	מלבושים
מאַלבושימלעך	מלבושימלעך
מאַלבעש	מלבוש
מאַלבעשל	מלבושל
מאַלבעש	מלביש
מאַלבעש־אומאַניל	מלביש־ומנעיל
מאַלבעש־אַרומים	מלביש־ערומים
מאַלגיירען	מעלה־גירהן
מאַלווים	מלווים
מאַלווים־בעריביס	מלווים־בריבית
מאַלווע	מלווה
מאַלווע־בעריביס	מלווה־בריבית
מאַ לי לעשאַקער	מה לי לשקר
מאַלכאַמאָוועס	מלאך־המוות
מאַלכעס	מלכות
מאַלכעסדיק	מלכותדיק
מאַלכעס־האָרעשאָע	מלכות־הרשעה
מאַלכעס־האָרעשע	מלכות־הרשע
מאַלכעס־ייִסראָעל	מלכות־ישׂראל
מאַלכעס־יעהודע	מלכות־יהודה
מאַלכעס־שאָמאַיִם	מלכות־שמים
מאַלן	מלן
מאָלע	מלא
מאָלע	מלא־
מאַלע	מלע
מאָלע־גאַזלען	מלא־גזלן
מאַלעגיירען	מעלה־גירהן
מאָלע־געדולע	מלא־גדולה
מאָלע־האָמען	מלא־המן
מאָלע־וועגאָדעש	מלא־וגדוש
מאָלע־טאַם	מלא־טעם
מאַלעך	מלאך
מאַלעכס	מלאכס
מאַלאָכים	מלאכים
מאַלאָכימס	מלאכימס
מאַלאָכימלעך	מלאכימלעך
מאַלעכאַמאָוועס	מלאך־המוות
מאַלעך־דוימע	מלאך־דומה
מאַלעך־האַגויעל	מלאך־הגואל
מאַלעך־האַדוימע	מלאך־הדומה
מאַלעך־האַמוישיִע	מלאך־המושיע
מאַלעך־האַשאָלעם	מלאך־השלום
מאָלע־כיימע	מלא־חמה
מאָלע־כיין	מלא־חן
מאַלעך־כאַבאָלע	מלאך־חבלה
מאַלעך־עליען	מלאך־עליון
מאַלען	מלען
מאָלע־סימכע	מלא־שׂימחה
מאָלע־קאַאַס	מלא־כּעס
מאָלע־ראַכמים	מלא־רחמים
מאָלע־רעציכע	מלא־רציחה
מאַלקיִעל	מלכּיאל
מאַלקע	מלכּה
מאַלקעס	מלכּהס
מאַלקען	מלכּהן
מאַלקעלע	מלכּהלע
מאַלקעלעס	מלכּהלעס
מאַלקעלען	מלכּהלען
מאַלקעס	מלכּות
מאַלקעס	מלקות
מאַלקע־קעדישע	מלכּא־קדישא
מאַלקע־שוואָ	מלכּה־שבֿאָ
מאַלשינעס	מלשינות
מאַלשן	מלשין
מאַמאָשעס	ממשות
מאַמזיירים	ממזרים
מאַמזיירעס	ממזרת
מאַמזער	ממזר
מאַמזערס	ממזרס
מאַמזער־בען־האַנידע	ממזר־בן־הנידה
מאַמזערטע	ממזרטע
מאַמזערטעס	ממזרטעס
מאַמזעריש	ממזריש
מאַמזערישער	ממזרישער
מאַמזערישע	ממזרישע
מאַמזערישן	ממזרישן
מאַמטאַקים	ממתּקים
מאַמלעץ	ממליץ
מאַמעלאָשן	מאַמע־לשון
מאָמען	ממון
מאָמען־קוירעך	ממון־קורח
מאַמעש	ממש
מאַמצע	ממציא
מאַמשעך	ממשיך
מאַן	מן
מאַ־נאָע	מה־נאה
מאַנדאָמאַר	מאַן־דאָמר
מאַנדעהו	מאַן־דהוא
מאַנהיגים	מנהיגים
מאַנהיגע־האַדאָר	מנהיגי־הדור
מאַ־נישטאַנע	מה־נשתּנה
מאַנעג	מנהיג
מאַנעג־האַדאָר	מנהיג־הדור
מאָנע־יאָפֿע	מנה־יפֿה
מאָנע־מעכאַייינע	מה אָנו ומה חיינו
מאָנעפֿשעך	ממה־נפֿשך
מאָנעשעך	ממה־נפֿשך
מאַס	מס
מאַסאָעס	משׂאָות
מאַסאָעס בעניאָמען האַשלישי	מסעות בנימין השלישי
מאַסבער	מסביר
מאַסטן	משׂטין
מאַסמידים	מתמידים
מאַסמידע	מתמידה
מאַסמעד	מתמיד
מאָסן	מתון
מאַסנע	מתנה
מאַסע	מסעי
מאַסע	משׂא
מאַסעג	משׂיג
מאַסעג־גוווּל	מסיג־גבֿול
מאַסעכעס	מסכת
מאַסעמאַטן	משׂא־מתּן
מאַסעפּאָנעם	משׂא־פּנים
מאַסע־קוויידע	משׂא־כּבֿדה
מאָסער	מוסר
מאָסער	מסור
מאַסער	מסר
מאַסערן	מסרן
מאַסערסט	מסרסט
מאַסערט	מסרט
געמאַסערט	געמסרט
מאַסערנדיק	מסרנדיק
מאַספּידים	מספּידים
מאַספּעד	מספּיד
מאַסקאָנע	מסקנא
מאַסקאָנעס	מסקנות
מאַסקילים	משׂכּילים
מאַסקל	משׂכּיל
מאַסקעם	מסכּים
מאַסקער	מזכּיר
מאַסקער־נעשאָמעס	מזכּיר־נשמות
מאָסרים	מסורים
מאַסריִעך	מסריח
מאַסרע	מתרה
מאָסרעס	מותרות
מאָעס	מאָוס
מאָעס	מעות
מאָעס־כיטים	מעות־חיטים
מאָעס־כיטן	מעות־חיטין
מאָער	מאור
מאָער־האַגוילע	מאור־הגולה
מאַפּאָלע	מפּלה
מאַפּאָלעס	מפּלות
מאַפּוילעס	מפּולת
מאַ פּישי	מה פּשעי
מאַפּל	מפּיל
מאַפּלקינד	מפּיל־קינד
מאַפּלקינדער	מפּיל־קינדער
מאַפּלען	מפּלען
געמאַפּלט	געמפּלט
מאַפּעלעך	מפּילעך
מאַפֿטיִעך	מבֿטיח
מאַפֿטער	מפֿטיר
מאַפֿכן	מבֿחין
מאַפֿלעג	מפֿליג
מאַפֿלע־לײַסעס	מפֿליא־לעשׂות
מאָפֿסים	מופֿתים
מאַפֿסעק	מפֿסיק
מאַפֿסעק־מישנאָסע	מפֿסיק־משנתו
מאַפֿצער	מפֿציר
מאַפֿקער	מפֿקיר
מאַצדעק	מצדיק
מאַצדעק־האַדין	מצדיק־הדין
מאַצייווע	מצבֿה
מאַצייוועס	מצבֿות
מאַצל	מציל
מאַצליִעך	מצליח
מאָצע	מוצאי־
מאַצע	מצה
מאַצעס	מצות
מאַצע־וואַסער	מצה־וואַסער
מאַצעוו	מצבֿ
מאָצע־שאַבעס	מוצאי־שבת
מאַצע־שמורע	מצה־שמורה
מאַקאַבי	מכּבי
מאַקאַבייער	מכּבייער
מאַקדעם	מקדים
מאַקדעש	מקדיש
מאַקכעש	מכּחיש
מאַקע	מכּה
מאַקע אַשער לוי קסוּווע באַטוירע	מכּה אַשר לא כּתובֿה בתּורה
מאָקעם	מקום
מאָקעם־גאָדל	מקום־גדול
מאָקעם־לעפּוראָניעס	מקום־לפּורעניות
מאָקעם־מיקלעט	מקום־מיקלט
מאָקעם־מענוכע	מקום־מנוחה
מאָקעם־קאָדעש	מקום־קדוש
מאַקעס	מכּות
מאַקעס־אַכזאָריעס	מכּות־אַכזריות
מאַקעס־מעדינע	מכּת־מדינה
מאַקעס־פּכוירעס	מכּת־בכורות
מאַקעס־רעצעך	מכּות־רצח
מאַקעף	מקף
מאָקער	מקור
מאַקער־טויווע	מכּיר־טובֿה
מאַקע שעלוי קסוּווע באַטוירע	מכּה שלא כּתובֿה בתּורה
מאַקפּידים	מקפּידים
מאַקפּעד	מקפּיד
מאַקרעוו	מקריבֿ
מאַקשאָנים	מקשנים
מאַקשן	מקשן
מאַקשע	מקשה
מאַקשע־ליילעד	מקשה־לילד
מאַר…	מהר…
מאַראָכע	מערכה
מאַראָכעס	מערכות
מאָראָנאָן וועראַבאָנאָן וועראַבויסײַ	מרנן ורבנן ורבותי
מאַראַש	מה־רעש
מאַרבן בעסימכע	מרבין בשׂימחה
מאַרבעץ־טוירע	מרביץ־תּורה
מאַרבערעבאַשע	מר־ברב־אַשי
מאַרבערעבאַשע	מר־בר־רב־אַשי
מאַרגל	מרגיל
מאַרגניסע־טאַווע	מרגניתא־טבֿא
מאַרגעש	מרגיש
מאָרדים	מורדים
מאָרדים־בעמאַלכעס	מורדים־במלכות
מאַרוויכער	מרוויחער
מאַרוויִעך	מרוויח
מאָרטכע	מרדכי
מאָרטכעס	מרדכיס
מאָרטכען	מרדכין
מאָרטכע האַצאַדיק	מרדכי הצדיק
מאַריס־אַיִן	מראית־עין
מאַריעם	מרים
מאַריעמס	מרימס
מאַריעמען	מרימען
מאַרכעוו	מרחיבֿ
מאַרכעזשוון	מרחשוון
מאַרכעק	מרחיק
מאַר־מימאָוועס	מר־ממוות
מאַרנעפֿעש	מר־נפֿש
מאַרע	מראה
מאָרע־דאַווראָהאָם	מריה־דאַבֿרהם
מאָרע־דאַסרע	מרא־דאַתרא
מאָרע־דעאַלמע־קולע	מריה־דעלמא־כּולה
מאָרע־דעאַסרע	מרא־דאַתרא
מאַרעוויכער	מרוויחער
מאַרע־מאָקעם	מראה־מקום
מאַרע־מעקוימעס	מראה־מקומות
מאָרע־נעפֿעש	מר־נפֿש
מאָרעס	מרת
מאַרע־קויען	מראה־כּהן
מאָרער	מרור
מאַרעש	מרעיש
מאַרעש־אוילעם	מרעיש־עולם
מאָרעשכוירע	מרה־שחורה
מאַרשאַס	מרשעת
מאַרשאַסן	מרשעתן
מאַשביִע	משביע
מאַשגיכים	משגיחים
מאַשגיִעך	משגיח
מאַשווע	משווה
מאַשטן	משתּין
מאַשכיסים	משחיתים
מאַשכעס	משחית
מאָשל	משל
מאָשלים	מושלים
מאָשלים־בעקיפּע	מושלים־בכּיפּה
מאַשלעם	משלים
מאַשלעש	משליש
מאָשל־קעכערעס־האַנישבער	משל־כּחרס־הנישבר
מאַשמאָעס	משמעות
מאַ שמייכעם	מה שמכם
מאַשמע	משמע
מאַ שמעכאָ	מה שמך
מאַשעהו	משהו
מאַשפּיִע	משפּיע
מאַשפּל	משפּיל
מאַשקאַנטע	משכּנתּא
מאַשקאָנעס	משכּונות
מאַשקאָעס	משקאָות
מאַשקן	משכּון
מאַשקע	משקה
מוהאַראַר	מוהר״ר
מוטל	מוטל
מוטל־בעסאָפֿעק	מוטל־בספֿק
מוטער	מותּר
מוידאָע	מודעה
מוידיִיִן	מודיעין
מוידים	מודים
מוידיִע	מודיע
מוידע	מודה
מוידע־אומיסוואַדע	מודה־ומתוודה
מוידע־אַני	מודה־אַני
מויכיכים	מוכיחים
מויכיִעך	מוכיח
מויכל	מוחל
מויכעס	מוחות
מויכעס	מוכס
מויכער	מוכר
מויכער־ספֿאָרים	מוכר־ספֿרים
מויכער־ספֿאָרימס	מוכר־ספֿרימס
מויכער־ספֿאָרימען	מוכר־ספֿרימען
מויכער־ספֿאָרימניק	מוכר־ספֿרימניק
מוילעד	מולד
מוילעד	מוליד
מוילעך	מולך
מוילעכער	מולכער
מויסעף	מוסיף
מויסער	מותר
מויסער־מוידאָע	מוסר־מודעה
מויסער־נעפֿעש	מוסר־נפֿש
מויסער קסאַוו זע	מוסר כּתבֿ זה
מויסרעס	מותרות
מויעד	מועד
מויעד־קאָטן	מועד־קטן
מויעוו	מואבֿ
מויעך	מוח
מויעכל	מוחל
מויעכן	מוחן
מויעל	מוהל
מויעל־מעל	מוהל־מעל
מויעלשאַפֿט	מוהלשאַפֿט
מויפֿעס	מופֿת
מויצע	המוציא
מויצע	מוציא
מויצעס	מוציאס
מויצע־זערע־לעוואַטאָלע	מוציא־זרע־לבֿטלה
מויצע־כיין	מוצא־חן
מויצע־לאַאַז	מוציא־לעז
מויצע־שנאָסע	מוציא־שנתו
מויצע־שעמראַ	מוציא־שם־רע
מויקירע	מוקירי־
מויקער	מוקיר־
מויריינע	מורנו
מויריינע האָראַוו רעב	מורנו הרבֿ רב
מויריינע וועראַביינע האָראַוו רעב	מורנו ורבנו הרבֿ רב
מוירע	מורא
מוירעד	מורד
מוירעד־בעמאַלכעס	מורד־במלכות
מוירעדיק	מוראדיק
מוירעדיקער	מוראדיקער
מוירעדיקע	מוראדיקע
מוירעדיקן	מוראדיקן
מוירעדיקס	מוראדיקס
מוירע־דערעך	מורה־דרך
מוירע־הויראָע	מורה־הוראה
מוירע־העטער	מורה־היתּר
מוירע־מויריינע	מורה־מורינו
מוירע־נעוווּכים	מורה־נבֿוכים
מוירעראָע	מורה־הוראה
מוישל	מושל
מוישל־בעקיפּע	מושל־בכּיפּה
מוישע	משה
מוישעס	משהס
מוישען	משהן
מוישעלע	משהלע
מוישעלעס	משהלעס
מוישעלען	משהלען
מוישעוו	מושבֿ
מוישעוו־לייצים	מושבֿ־לצים
מוישעוו־סקיינים	מושבֿ־זקנים
מוישע ראַביינע	משה רבנו
מוישע ראַביינעס	משה רבנוס
מוכזעק	מוחזק
מוכן	מוכן
מוכן־אומזומען	מוכן־ומזומן
מוכרעם	מוחרם
מום	מום
מומים	מומים
מומאָרים	מומרים
מומכים	מומחים
מומכע	מומחה
מומכעטע	מומחהטע
מומכענטע	מומחהנטע
מומער	מומר
מומער־לעהאַכעס	מומר־להכעיס
מומער־לעטעאָוון	מומר־לתּאָבֿון
מומרים	מומרים
מוסאָפֿים	מוספֿים
מוסעף	מוסף
מוסער	מוסר
מוסער־ליטעראַטור	מוסר־ליטעראַטור
מוסער־האַסקל	מוסר־השׂכּל
מוסערן	מוסרן
מוסערניק	מוסרניק
מוסער־סייפֿער	מוסר־ספֿר
מוסער־ספֿאָרים	מוסר־ספֿרים
מוסקעם	מוסכּם
מופֿלאָגים	מופֿלגים
מופֿלעג	מופֿלג
מופֿלעג־באַטוירע	מופֿלג־בתּורה
מופֿלעג־טוירע	מופֿלג־תּורה
מופֿקאָרים	מופֿקרים
מופֿקער	מופֿקר
מופֿקערעס	מופֿקרת
מוצלאָכים	מוצלחים
מוצלעך	מוצלח
מוקאַז	מוכּז
מוקאַז	מוכּ״ז
מוקדעם אומעוכער	מוקדם ומאוחר
מוקעס־עץ	מוכּת־עץ
מוקצע	מוקצה
מוקצע־מאַכמעס־מיִעס	מוקצה־מחמת־מיאוס
מוקשע	מוקשה
מורשים	מורשים
מורשע	מורשה
מושווע	מושווה
מושלאָמים	מושלמים
מושלעם	מושלם
מושלעמעס	מושלמת
מושפּע	מושפּע
מי…	מ…
מיבאָד־יאָם	מבעוד־יום
מיבאַיִס־לעבאַיִס	מבית־לבית
מיבעטן־וועליידע	מבטן־ולידה
מיגדעש	מיקדש
מיגיִע־קאַפּע	מיגיע־כּפּו
מיגיִע־קאַפּעאָ	מיגיע־כּפּיה
מיגיִע־קאַפּעוו	מיגיע־כּפּיו
מיגע	מיגו
מידאָר לעדאָר	מדור לדור
מידבאָריעס	מידבריות
מידבער	מדבר
מידבער	מידבר
מידוירײַסע	מדאורײַתא
מידיי יאָם בעיוימע	מדי יום ביומו
מידיי כוידעש בעכאָטשע	מדי חודש בחודשו
מידייע	מי־יודע
מידיי שאַבעס בעשאַבאַטע	מדי שבת בשבתּו
מידיען	מידין
מידע	מידה
מידע־בזוּיע	מידה־בזויה
מידע־טויווע	מידה־טובֿה
מידע־מעגונע	מידה־מגונה
מידעס	מידות
מידעס־האַדין	מידת־הדין
מידעס־האָראַכמים	מידת־הרחמים
מידעס־זדאָם	מידת־סדום
מידע קענעגעד מידע	מידה כּנגד מידה
מידראַבאָנען	מדרבנן
מי־וואָייש אומי־וואַמאַיִם	מי־בֿאש ומי־בֿמים
מי וואָמי	מי ומי
מישעניכנעס אָדער	מי שנכנס אָדר
מישעניכנעס אָדער	משנכנס אָדר
מי וואָמי האָהוילכים	מי ומי ההולכים
מיִוטים	מיעוטים
מיזבייכעס	מזבחות
מיזבייעך	מזבח
מיזדאַוועג	מזדווג
מיזמוירים	מיזמורים
מיזמער	מיזמור
מיזראָכי	מזרחי
מיזראָכים	מיזרחים
מיזרעך	מיזרח
מיטאָך	מתּוך
מיטאָך־האַמײַסע	מתּוך־המעשׂה
מיטאָך־סכאָק	מתּוך־שׂחוק
מיטאַמער־וועוילע	מתּמר־ועולה
מיטע	מטה
מיטע	מיטה
מיִיאַד	מיד
מיִיאַד־לעיאַד	מיד־ליד
מי יאָמעס	מי ימות
מײַדאַנים	מעדנים
מײַדאַנע־מיילעך	מעדני־מלך
מײַדאַנע־מלאָכים	מעדני־מלכים
מײַדעם	מאדים
מײַ דעקאָאַמרע ראַבאָנען	מאַי דקאמרי רבנן
מײַ דעקאָאַמרע רעבעצן	מאַי דקאמרי רביצין
מייוון	מבֿין
מייוון־בעלאָשן	מבֿין־בלשון
מייוונטע	מבֿינטע
מייוונטעס	מבֿינטעס
מייוון־קאָל־דיבער	מבֿין־כּל־דיבור
מײַווער	מעבֿיר
מײַווער־יאַבעק	מעבֿר־יבוק
מײַווער־נאַכלע	מעבֿיר־נחלה
מײַווער־סעדרע	מעבֿיר־סדרה
מײַ טײַמע	מאַי טעמא
מייטעוו	מטיבֿ
מייטעוו־כאָלעם	מטיבֿ־חלום
מײַטעק	מעתּיק
מי ייִכיע	מי יחיה
מײַכאָלים	מאכלים
מײַכאָלעס־אַסורעס	מאכלות־אַסורות
מייכושים	מיחושים
מײַכל	מאכל
מייכל	מוחל
מײַכל־טאַרפֿעס	מאכיל־טרפֿות
מײַכל־מלאָכים	מאכל־מלכים
מייכן	מכין
מייכע־טייסע	מהיכא־תּיתי
מייכעש	מיחוש
מײַלאָסע	מעלתו
מײַלן באַקוידעש	מעלין בקודש
מיילע	מילא
מײַלע	מעלה
מײַלעס	מעלות
מײַלע־גיירע	מעלה־גירה
מיילעך	מלך
מיילעך־בעקיפּע	מלך־בכּיפּה
מיילעך־כעסעד	מלך־חסד
מיילעך־מאַלכע־האַמלאָכים	מלך־מלכי־המלכים
מיילעך־עוויען	מלך־אבֿיון
מײַלעם	מעלים
מיילעץ	מליץ
מיילעץ־יוישער	מליץ־יושר
מיילעץ־יוישערטע	מליץ־יושרטע
מײַמאָדעס	מעמדות
מײַמאָרים	מאמרים
מײַמאָרע־כאַזאַל	מאמרי־חז״ל
מײַמינים	מאמינים
מײַמעד	מעמד
מײַמען	מאמין
מיימעסן	ממיתן
מײַמעק	מעמיק
מײַמער	מאמר
מײַמער־האַמוסגער	מאמר־המוסגר
מײַמעריסטיק	מאמריסטיק
מײַמער־כאַזאַל	מאמר־חז״ל
מײַ נאַפֿקע־מינע	מאַי נפֿקא־מינה
מײַנע	מענה
מײַנעס	מענות
מײַנע־לאָשן	מענה־לשון
מײַנעש	מעניש
מײַסים	מעשׂים
מייסים	מתים
מײַסים־אַשער־לוי־יעאָסו	מעשׂים־אשר־לא־יעשׂו
מײַסים־בעכאָל־יאָם	מעשׂים־בכל־יום
מײַסים־טאַטויִם	מעשׂים־תּעתּועים
מײַסים־טויווים	מעשׂים־טובֿים
מײַסים־ראָיִם	מעשׂים־רעים
מייסיס־אומעדיִעך	מסית־ומדיח
מייסיִעך־לעפֿי־טומע	מסיח־לפֿי־תּומו
מײַסע	מעשׂה
מײַסע־ביכל	מעשׂה־ביכל
מײַסע־אוינען	מעשׂה־אונן
מײַסע־בעטאָך־מײַסע	מעשׂה־בתּוך־מעשׂה
מײַסע־בריישעס	מעשׂה־בראשית
מײַסע־טאַטויִם	מעשׂה־תּעתּועים
מײַסע־יאָדאָוו	מעשׂי־ידיו
מײַסע־יאָדײַ	מעשׂי־ידי
מייסע־מידבער	מתי־מידבר
מייסע־מיצווע	מתי־מיצווה
מײַסע־מערקאָווע	מעשׂה־מרכּבֿה
מײַסע־נוירע	מעשׂה־נורא
מײַסע־ניסים	מעשׂה־נסים
מײַסע־ניפֿלע	מעשׂה־ניפֿלא
מײַסעס	מעשׂיות
מײַסע־סאָטן	מעשׂה־שׂטן
מײַסע־סדאָם	מעשׂה־סדום
מײַסער	מעשׂר
מײַסע־ראַ	מעשׂה־רע
מײַסער־שייני	מעשׂר־שני
מײַסע־שעהויע	מעשׂה־שהיה
מײַסרעס	מעשׂרות
מייע	מאה
מייעס	מאות
מי־יעדייע	מי־יודע
מייער	מאיר
מייער באַל־האַנעס	מאיר בעל־הנס
מייער באַל־נעס	מאיר בעל־נס
מײַ קאָ מאַשמע לאָן	מאַי קאָ משמע לן
מײַ קולע הײַ	מאַי כּולי האַי
מייקל	מקיל
מייקען	מקיאן
מייקענען	מקיאנען
מײַקערן	מעקרן
מײַריכים	מאריכים
מיירע	מערה
מײַרע	מערה
מײַרעוו	מערבֿ
מײַרעוו	מעריבֿ
מײַרעך	מאריך
מײַרעך־יאָמים	מאריך־ימים
מײַרעך־יאָמים־וועשאָנים	מאריך־ימים־ושנים
מיישעוו	משיבֿ
מיישעוו־שאָלעם	משיבֿ־שלום
מײַשער	מעשיר
מיכאָעל	מיכאל
מיכוץ	מחוץ
מיכוץ־לאָאָרעץ	מחוץ־לאָרץ
מיכוץ־לאָיִר	מחוץ־לעיר
מיכוץ־לאַמאַכנע	מחוץ־למחנה
מיכוץ־לעדערעך־האַטעווע	מחוץ־לדרך־הטבֿע
מיכטאָווים	מיכתּבֿים
מיכטעוו	מיכתּבֿ
מיכיע	מחיה
מיכנעסאַיִם	מכנסים
מיכע	מיכה
מיכשוילים	מיכשולים
מיכשל	מיכשול
מי לאָנו גאָדל מי…	מי לנו גדול מ…
מילכאָמע	מלחמה
מילכאָמעס	מלחמות
מילכעמעס־גאָג־אומאָגעג	מלחמת־גוג־ומגוג
מילסע־דיבדיכעסע	מילתא־דבדיחותא
מילע	מילה
מילע־דיבדיכעסע	מילתא־דבדיחותא
מילע־דעאַלמע	מילי־דעלמא
מילעל	מלעיל
מילראַ	מלרע
מימאַאַמאַקים	ממעמקים
מימיילע	ממילא
מין	מין
מינים	מינים
מין	מן
מינאַאַר וועאַד זאָקן	מנער ועד זקן
מינאַדין	מן־הדין
מינאַסטאַם	מן־הסתּם
מינאַצאַד	מן־הצד
מין־אַשאָמאַיִם	מן־השמים
מינהאָגים	מינהגים
מין־האַטוירע	מן־התּורה
מין־האַמופֿכער	מן־המובֿחר
מין־האַסאָפֿע־וועלאַכוץ	מן־השׂפֿה־ולחוץ
מין האַקויעך על האַפּויעל	מן הכּוח אל הפּועל
מין־האַשאָמאַיִם	מן־השמים
מין־זאָכער	מין־זכר
מיניאָנים	מנינים
מיניען	מנין
מינכע	מינחה
מינכע־גדוילע	מינחה־גדולה
מינכע־קטאַנע	מינחה־קטנה
מין־נעקייווע	מין־נקבֿה
מין־סטאַם	מין־סתּם
מינעג	מינהג
בעמינעג	במינהג
מינעג־האָוילעם	מינהג־העולם
מינעג־האַמעדינע	מינהג־המדינה
מינעג־יאָשן	מינהג־ישן
מינעג־שטוס	מינהג־שטות
מינעס	מינות
מינע־קיטניעס	מיני־קיטניות
מי סאָמכאָ	מי שׂמך
מיסאַסעף	מתאַסף
מיסאַסעק	מתעסק
מיסאַסעק־בעמיצוועס	מתעסק־במיצוות
מיסאַסעק־בעצאָרכע־ציבער	מתעסק־בצרכי־ציבור
מיסאַסקים	מתעסקים
מיסאַסקים־בעמיצוועס	מתעסקים־במיצוות
מיסאַסקים־בעצאָרכע־ציבער	מתעסקים־בצרכי־ציבור
מיסבוידעד	מתבודד
מיסבוינען	מתבונן
מיסגאַבער	מתגבר
מיסדאַבעק	מתדבק
מיסוואַדע	מתוודה
מיסוואַקייעך	מתווכּח
מיסוירער	מתעורר
מיסטאַגעף	מסתּגף
מיסטאַם	מסתּם
מיסטאַמע	מסתּמא
מיסטאָמע	מסתּמא
מיסטאַפּעק־בעמועט	מסתּפּק־במועט
מיסטאַפּקים־בעמועט	מסתּפּקים־במועט
מיסיאַכעד	מתיחד
מיסיאַכעס	מתיחס
מיסיאַעץ	מתיעץ
מיסיאַעש	מתיאש
מיסים	מסים
מיסינײַ	מסיני
מיסכאַבער	מתחבר
מיסכאַוון	מתכוון
מיסכאַטן	מתחתּן
מיסכאַנען	מתחנן
מיסכאַקעם	מתחכּם
מיסכאָרים	מיסחרים
מיסכײַעוו	מתחייבֿ
מיסכײַעוו־בענאַפֿשע	מתחייבֿ־בנפֿשו
מיסכער	מיסחר
מיסנאַגדים	מתנגדים
מיסנאַגדיש	מתנגדיש
מיסנאַגדישער	מתנגדישער
מיסנאַגדישע	מתנגדישע
מיסנאַגדישן	מתנגדישן
מיסנאַגדעס	מתנגדות
מיסנאַגעד	מתנגד
מיסנאַצל	מתנצל
מיסע	מיתה
מיסע־בינשיקע	מיתה־בנשיקה
מיסע־מעשונע	מיתה־משונה
מיספּאַלעל	מתפּלל
מיספּאָרים	מיספּרים
מיספּער	מיספּר
מיספּער־גאָדל	מיספּר־גדול
מיספּער־קאָטן	מיספּר־קטן
מיסקאַנע	מתקנא
מיסראַכעק	מתרחק
מיסראַעם	מתרעם
מיִעט	מיעוט
מיִעס	מיאוס
מיִעסער	מיאוסער
מיִעסע	מיאוסע
מיִעס־אומאָעס	מיאוס־ומאָוס
מיִעסן	מיאוסן
מיִעסקייט	מיאוסקייט
מיִעסקייטן	מיאוסקייטן
מיפּיוו־האַקאָדעש	מפּיו־הקדוש
מיפּניי־דאַרקע־שאָלעם	מפּני־דרכּי־שלום
מיפּעסעך־בייסע	מפּתח־ביתו
מיצאַד	מצד
מיצווע	מיצווה
מיצוועס	מיצוות
מיצווע־טאַנץ	מיצווה־טאַנץ
מיצוועס־אײַסע	מיצוות־עשׂה
מיצוועס־לויסײַסע	מיצוות־לא־תעשׂה
מיצוועס־לויסעסע	מיצוות־לא־תעשׂה
מיצוועס־עסע	מיצוות־עשׂה
מיצטאַרעף	מצטרף
מיצנעפֿעס	מצנפֿת
מיצראַיִם	מצרים
מיצרי	מיצרי
מיצריס	מיצרית
מיצריִעס	מיצריות
מיצריש	מיצריש
מיקאַדמוינים	מקדמונים
מיקאַדמעס־דענאָ	מקדמת־דנאָ
מיקאָטן־ועאַד־גאָדל	מקטן־ועד־גדול
מיקאָל־האַמינים	מכּל־המינים
מיקאָל־האַמינים־שעהו	מכּל־המינים־שהוא
מיקאָל־טוּוו	מכּל־טובֿ
מיקאָל־מײַמינים־שעהו	מכּל־מאמינים־שהוא
מיקאָלשקן	מכּל־שכּן
מיקאַמע	מכּמה
מיקאַמע־וועקאַמע טײַמים	מכּמה־וכּמה טעמים
קאַמע־וועקאַמע טײַמים	כּמה־וכּמה טעמים
מיקאַמע טײַמים	מכּמה טעמים
מיקאַמע־וועקאַמע שאָנים	מכּמה־וכּמה שנים
מיקאַמע שאָנים	מכּמה שנים
מיקאַק	מק״ק
מיקדעש	מקדש
מיקוואָעס	מיקוואָות
מיקוואָעס	מיקוות
מיקווע	מיקווה
מיקויעך	מכּוח
מיקויעכן	מכּוחן
מיקויעך על האַפּויעל	מכּוח אל הפּועל
מיקלאָטים	מיקלטים
מיקלוימערשט	מכּלומרשט
מיקלעט	מיקלט
מיקעהילע־קדוישע	מקהילה־קדושה
מיקעץ	מקץ
מיקצעס־מין־האַמיקצעס	מקצת־מן־המקצת
מיקראָעס־גדוילעס	מקראָות־גדולות
מיקרים	מיקרים
מיקרע	מיקרה
מיריעם	מרים
מיריעמס	מרימס
מיריעמען	מרימען
מיריעם האַנעוויִע	מרים הנבֿיאה
מיריעם האַנעוויִעס	מרים הנבֿיאהס
מירצעשעם	אם־ירצה־השם
מירשאַס	מרשעת
מירשאַסן	מרשעתן
מישאַבעס־לעשאַבעס	משבת־לשבת
מישאָנים־קאַדמויניעס	משנים־קדמוניות
מישום	משום
מישום־דאַרקע־האַשאָלעם	משום־דרכּי־השלום
מישום־מאַריס־אַיִן	משום־מראית־עין
מישוראַס	משרת
מישטאַדל	משתּדל
מישטאַטייעך	משתּטח
מישטאַטעף	משתּתּף
מישיישעס־יעמיי־בריישעס	מששת־ימי־בראשית
מישיכמע־וואָמײַלע	משכמו־ומעלה
מישלאַכעס	משלחת
מישלויעך־מאָנעס	משלוח־מנות
מישלע	משלי
מישמאָרים	מישמרים
מישמוירעס	משמורת
מישמער	מישמר
מישנײַעס	משניות
מישנײַעסן	משניותן
מישנע	מישנה
מישנע	משנה
מישנע־טוירע	מישנה־תּורה
מישנע־לאַמיילעך	מישנה־למלך
מישעביירעך	מי־שברך
מישעלאָנו	משלנו
מישפּאָטים	מישפּטים
מישפּאָטים	משפּטים
מישפּאַכטע	משפּחטע
מישפּאַכטעס	משפּחטעס
מישפּאַכטערע	משפּחטערע
מישפּאַכטערעס	משפּחטערעס
מישפּאָכע	משפּחה
מישפּאָכעדיק	משפּחהדיק
מישפּאָכעדיקער	משפּחהדיקער
מישפּאָכעדיקע	משפּחהדיקע
מישפּאָכעדיקן	משפּחהדיקן
מישפּאָכעדיקס	משפּחהדיקס
מישפּאָכעס	משפּחות
מישפּעט	מישפּט
מישפּעטן	מישפּטן
געמישפּעט	געמישפּט
מישקאָלים	מישקלים
מישקאַנטע	משכּנתּא
מישקוילעס	משקולת
מישקל	מישקל
מישקן	מישכּן
מישקעוו־בעהיימע	מישכּבֿ־בהמה
מישקעוו־זאָכער	מישכּבֿ־זכור
מישקעוו־זאָכער	מישכּבֿ־זכר
מכאַק	מחק
מלאָכים	מלכים
מלוי־קוימאָסע	מלא־קומתו
מנאָכעס	מנחות
מע	מה
מע…	מ…
מעאַאַווע	מאַהבֿה
מעאַאַוועס	מאַהבֿת־
מעאַאַוועס־מאָרטכע	מאַהבֿת־מרדכי
מעאַבעד	מאַבד
מעאַבעד־אַצמע־לאַדאַאַס	מאַבד־עצמו־לדעת
מעאַבעד־מאָמען	מאַבד־ממון
מעאַגן	מעגן
מעאַהאַווע	מאַהבֿה
מעאַהאַוועס	מאַהבֿת־
מעאַהאַוועס־מאָרטכע	מאַהבֿת־מרדכי
מעאַוודעס לעכיירעס	מעבֿדות לחירות
מעאַכויריי־האַפּאַרגעד	מאַחורי־הפּרגוד
מעאַכעד	מאַחד
מעאַנעס	מאַנס
מעאַסעף	מאַסף
מעאַסעף־מאָמען	מאַסף־ממון
מעאַקל	מעכּל
מעאַקעוו	מעכּבֿ
מעאַקעוו־האַקריִע	מעכּבֿ־הקריאה
מעאַרבע פּינעס־האָוילעם	מאַרבע פּינות־העולם
מעאַרבע קאַנפֿעס־האָאָרעץ	מאַרבע כּנפֿות־האָרץ
מעאָרעס־האַמאַכפּיילע	מערת־המכפּלה
מעאָרעס־פּריצים	מערת־פּריצים
מעאַרער	מערער
מעגאַדל	מגדל
מעגאַזעם	מגזם
מעגאַלע	מגלה
מעגאַלע־טמירן	מגלה־טמירין
מעגאַמגעם	מגמגם
מעגולגל	מגולגל
מעגונע	מגונה
מעגושעם	מגושם
מעגושעמדיק	מגושמדיק
מעגײַער	מגייר
מעגילע	מגילה
מעגילעס	מגילות
מעגילעס־אייכע	מגילת־איכה
מעגילעס־עסטער	מגילת־אסתּר
מעגילעס־רוס	מגילת־רות
מעדאַבעק	מדבק
מעדאַבער	מדבר
מעדאָע	מודעה
מעדאַקדעק	מדקדק
מעדובער	מדובר
מעדינע	מדינה
מעדינעס	מדינות
מעדינע־גייער	מדינה־גייער
מעדינע־כאַכאָמים	מדינה־חכמים
מעדינע־כאָכעם	מדינה־חכם
מעדינעס	מדינת־
מעדינעס־ייִסראָעל	מדינת־ישׂראל
מעדיִע	מודיע
מעדראָשים	מדרשים
מעדרעש	מדרש
מעהאַדער	מהדר
מעהאַדרין־מין־האַמעהאַדרין	מהדרין־מן־המהדרין
מעהאָכייל וועאַד קאָלאָ	מהחל ועד כּלה
מעהאַלעך	מהלך
מעהאַלעך־ראַוו	מהלך־רבֿ
מעהאַנע	מהנה
מעהאַפּעך	מהפּך
מעהאַרהער	מהרהר
מעהאַרער	מהרהר
מעהודאָרים	מהודרים
מעהודער	מהודר
מעהומע	מהומה
מעהומעס	מהומות
מעהוס	מהות
מעהײַ־טײַמע	מהאַי־טעמא
מעהײַעם וואָהאָלע	מהיום והלאה
מעהירעס	מהירות
מעובערעס	מעוברת
מעוואַזע	מבֿזה
מעוואַטל	מבֿטל
מעוואַטער	מוותּר
מעוואַטער	מותּר
מעוואַלבל	מבֿלבל
מעוואַסער	מבֿשׂר
מעוואַסער־פּסורע	מבֿשׂר־בשׂורה
מעוואַער	מבֿאר
מעוואַער	מבֿער
מעוואַער־כאָמעץ	מבֿער־חמץ
מעוואַקער־כוילע	מבֿקר־חולה
מעוווּזע	מבֿוזה
מעוווּזע־אומעוואַזע	מבֿוזה־ומבֿזה
מעוווּיעש	מבֿויש
מעוווּלבל	מבֿולבל
מעוווּסעם	מבֿוסם
מעוווּעל	מבֿוהל
מעוווּעלדיק	מבֿוהלדיק
מעווײַעש	מבֿייש
מעווינים	מבֿינים
מעווינעס	מבֿינות
מעוּיעמדיק	מאוימדיק
מעויר עכאָד	מעור אחד
מעוירער	מעורר
מעורעוו־אים־האַבריִעס	מעורבֿ־עם־הבריות
מעזאַוועג	מזווג
מעזאַלזל	מזלזל
מעזאַנע	מזנה
מעזאַקע	מזכּה
מעזאַרעז	מזרז
מעזוזע	מזוזה
מעזוזעס	מזוזות
מעזוינעס	מזונות
מעזומאָנים	מזומנים
מעזומען	מזומן
מעזיוו־האַשכינע	מזיוו־השכינה
מעזעקטאָוו	מזג־טובֿ
מעטאַטרען	מטטרון
מעטאַלטעלים	מטלטלים
מעטאַלטעלן	מטלטלין
מעטאַמע	מטמא
מעטאַער	מטהר
מעטאַפּל	מטפּל
מעטופּאָלים	מטופּלים
מעטופּל	מטופּל
מעטוראָפֿים	מטורפֿים
מעטורעף	מטורף
מעטורעפֿעס	מטורפֿת
מעטושטעש	מטושטש
מעיאַבעם	מיבם
מעיאַזדים	מיסדים
מעיאַטער	מיתּר
מעיאַכעד	מיחד
מעיאַכעס	מיחס
מעיאַסעד	מיסד
מעיאַעש	מיאש
מעיאַשעוו	מישבֿ
מעיאַשעוו	מיישבֿ
מעיִד	מעיד
מעיוכאָסים	מיוחסים
מעיוכעס	מיוחס
מעיוכעסטע	מיוחסטע
מעיוכעסעס	מיוחסת
מעיושעוו	מיושבֿ
מעיושעוודיק	מיושבֿדיק
מעיִז	מעיז
מעיִז־פּאָנעם	מעיז־פּנים
מעייווער־לעיאַם	מעבֿר־לים
מעיימעס־יאָם־האַדין	מאימת־יום־הדין
מעײַעם	מאַיים
מעײַען	מעיין
מעיִלע	מעילה
מעיִניאָנע־דעיוימע	מעניני־דיומא
מעכאַבאָלים	מחבלים
מעכאַבל	מחבל
מעכאַבלים	מחבלים
מעכאַבעד	מכבד
מעכאַבעוו	מחבבֿ
מעכאַבעק־אומענאַשעק	מחבק־ומנשק
מעכאַבער	מחבר
מעכאַבערס	מחברס
מעכאַברים	מחברים
מעכאַדעש	מחדש
מעכאַדשים	מחדשים
מעכאַוון	מכוון
מעכאַטשים	מחדשים
מעכאַלעל	מחלל
מעכאַלעל־האַשעם	מחלל־השם
מעכאַלעל־קוידעש	מחלל־קודש
מעכאַלעל־שאַבעס	מחלל־שבת
מעכאַלעל־שעם	מחלל־שם
מעכאַלעל־שעם־שאָמאַיִם	מחלל־שם־שמים
מעכאַלעל־שעם־שאָמאַיִם בעפֿערעסיע	מחלל־שם־שמים בפֿרהסיא
מעכאַנעך	מחנך
מעכאַסער	מחסר
מעכאַפּער	מכפּר
מעכאַפּער־פּאָנעם	מכפּר־פּנים
מעכאַק	מחק
מעכאַרעף־אומעגאַדעף	מחרף־ומגדף
מעכאַשעף	מכשף
מעכאַשעפֿטע	מכשפֿטע
מעכאַשפֿים	מכשפֿים
מעכובאָדים	מכובדים
מעכובעד	מכובד
מעכוטאָנים	מחותּנים
מעכוטאָנעמשאַפֿט	מחותּנימשאַפֿט
מעכוטאָנעסשאַפֿט	מחותּנותשאַפֿט
מעכוטאָנעשאַפֿט	מחותּנישאַפֿט
מעכוטן	מחותּן
מעכוטנס	מחותּנס
מעכוטענעסטע	מחותּנתטע
מעכוטענעסטעס	מחותּנתטעס
מעכוּיעוו	מחויבֿ
מעכוּיעוו־גאָלעס	מחויבֿ־גלות
מעכולע	מכולה
מעכולעק	מחולק
מעכוסער	מחוסר־
מעכוסער־לעכעם	מחוסר־לחם
מעכוסרע	מחוסרי־
מעכוסרע־לעכעם	מחוסרי־לחם
מעכוערעס	מכוערת
מעכוץ	מחוץ
מעכוצאָפֿים	מחוצפֿים
מעכוץ־לאָאָרעץ	מחוץ־לאָרץ
מעכוץ־לאָיִר	מחוץ־לעיר
מעכוץ־לאַמאַכנע	מחוץ־למחנה
מעכוץ־לעדערעך־האַטעווע	מחוץ־לדרך־הטבֿע
מעכוצענער	מחוצנער
מעכוצעף	מחוצף
מעכוצעף־פּאָנעם	מחוצף־פּנים
מעכוצעפֿטע	מחוצפֿטע
מעכוראַס	מכוערת
מעכטייסע	מהיכא־תּיתי
מעכטייסעדיק	מהיכא־תּיתידיק
מעכטייסעניצע	מהיכא־תּיתיניצע
מעכטייסעניק	מהיכא־תּיתיניק
מעכײַע	מחיה
מעכײַעס	מחיות
מעכײַעוו	מחייבֿ
מעכײַע־מייסים	מחיה־מתים
מעכײַע־נעפֿאָשעס	מחיה־נפֿשות
מעכילע	מחילה
מעכילע־גמורע	מחילה־גמורה
מעכיצע	מחיצה
מעכיצעס	מחיצות
מעכירע	מכירה
מעכירעס־יויסעף	מכירת־יוסף
מעכירעס־כאָמעץ	מכירת־חמץ
מעכעס	מכס
מעלאַווים	מלווים
מעלאַווע	מלווה
מעלאַווע־מאַלקע	מלווה־מלכּה
מעלאָכע	מלאָכה
מעלאָכעס	מלאָכות
מעלאָכע־בזוּיע	מלאָכה־בזויה
מעלאָכען	מלאָכהן
מעלאָכענען	מלאָכהנען
מעלאַמדים	מלמדים
מעלאַמדעס	מלמדות
מעלאַמעד	מלמד
מעלאַמעד־סכוס	מלמד־זכות
מעלאַמעטקע	מלמדקע
מעלוכע	מלוכה
מעלוכעס	מלוכות
מעלומאָדים	מלומדים
מעלומדעס	מלומדות
מעלומעד	מלומד
מעלומעדעס	מלומדת
מעלופּן	מלופּן
מעליצים	מליצים
מעליצע	מליצה
מעליצעס	מליצות
מעליצע־יוישער	מליצי־יושר
מעם	מ
מעם	מם
מעמאַלע	ממלא
מעמאַלע־מאָקעם	ממלא־מקום
מעמאַלע־מעקוימע	ממלא־מקומו
מעמוכן	ממוכן
מעמונים	ממונים
מעמונע	ממונה
מעם־טעס שאַאַרע־טומע	מ״ט שערי־טומאה
מעמרע	מימרא
מעמשאָלע	ממשלה
מענאַגן	מנגן
מענאַדווים	מנדבֿים
מענאַדעוו	מנדבֿ
מענאַדער	מנדר
מענאַהעל	מנהל
מענאַכעם	מנחם
מענאַכעמס	מנחמס
מענאַכעמען	מנחמען
מענאַכעמאָוו	מנחם־אָבֿ
מענאַכעם־אָוול	מנחם־אָבֿל
מענאַלים	מנהלים
מענאַצייעך	מנצח
מענאַקע	מנכּה
מענאַקער	מנקר
מענאַקרים	מנקרים
מענאַשע	מנשה
מענאַשעכע	מנשהכע
מענאַשעכעס	מנשהכעס
מענאַשעכען	מנשהכען
מענאַשעס	מנשהס
מענאַשען	מנשהן
מענוּוואָלים	מנוּוולים
מענוּוול	מנוּוול
מענוּוולטע	מנוּוולטע
מענוּוולטעס	מנוּוולטעס
מענוּוועלעס	מנוּוולת
מענוירע	מנורה
מענוירעס	מנורות
מענוירעס־האַמאָער	מנורת־המאור
מענוכע	מנוחה
מענוקעד	מנוקד
מעניי־אוּוויי	מניה־וביה
מענייביי	מניה־וביה
מעניִע	מניעה
מעניִעס	מניעות
מעס	מת
מעסאַבעוו	מסבבֿ
מעסאַבעוו־קאָל־האַסיבעס	מסבבֿ־כּל־הסיבות
מעסאַדער	מסדר
מעסאַדער־קדושן	מסדר־קידושין
מעסאַדער־קידושן	מסדר־קידושין
מעסאַלסל־בעסיירע	מסלסל־בשׂערו
מעסאַלעק	מסלק
מעסאַמייעך	משׂמח
מעסאַקן	מתקן
מעסאַרעס	מסרס
מעסאַרעץ	מתרץ
מעסוגל	מסוגל
מעסוירע	מסורה
מעסונים	מתונים
מעסופּעק	מסופּק
מעסוקן	מסוכּן
מעסושעלעך	מתושלח
מעס־טאָהער	מת־טהור
מעסיבע	מסיבה
מעסיבעס	מסיבות
מעסײַעם	מסיים
מעסיכטע	מסיכתּא
מעסיכטעס	מסיכתּות
מעסינעס	מתינות
מעסינעס־האָמען	משׂינאת־המן
מעסיפֿטע	מתיבֿתּא
מעסיקעס	מתיקות
מעסיקעסדיק	מתיקותדיק
מעסיקעסדיקער	מתיקותדיקער
מעסיקעסדיקע	מתיקותדיקע
מעסיקעסדיקן	מתיקותדיקן
מעסיקעסדיקס	מתיקותדיקס
מעסירע	מסירה
מעסירעס	מסירות
מעסירעלע	מסירהלע
מעסירעס־מעדאָע	מסירת־מודעה
מעסירעס־נעפֿעש	מסירת־נפֿש
מעסירעס־האַנעפֿעש	מסירת־הנפֿש
מעסלעס	מעת־לעת
מעס־מיצווע	מת־מיצווה
מעסן	מתן
מעסעכטע	מסכתּא
מעסעכטעס	מסכתּות
מעפֿאַטע	מפֿתּה
מעפֿאַלפּל	מפֿלפּל
מעפֿאַצע	מפֿצה
מעפֿאַרנעס	מפֿרנס
מעפֿאָרסעם	מפֿורסם
מעפֿאַרסעם	מפֿרסם
מעפֿאַרעש	מפֿרש
מעפֿאָרשים	מפֿרשים
מעפֿולפּל	מפֿולפּל
מעפֿונאָקים	מפֿונקים
מעפֿוניצע	מפֿוניצע
מעפֿוניצעס	מפֿוניצעס
מעפֿונעק	מפֿונק
מעפֿורסאָמים	מפֿורסמים
מעפֿורסעם	מפֿורסם
מעפֿײַעס	מפֿייס
מעפֿיצע־האַסקאָלע	מפֿיצי־השׂכּלה
מעפֿיצע־ספֿאַס־אייווער	מפֿיצי־שׂפֿת־עבֿר
מעצאַמצעם	מצמצם
מעצאַער	מצער
מעצאַרעף	מצרף
מעצודעס־דאָוויד	מצודת־דוד
מעצודעס־ציִען	מצודת־ציון
מעצויראַאַס	מצורעת
מעצויראָיִם	מצורעים
מעצוירע	מצורע
מעציִע	מציאה
מעציִעס	מציאות
מעציצע	מציצה
מעקאַבל	מקבל
מעקאַבל־בעאַאַווע	מקבל־באַהבֿה
מעקאַבל־בעאַהאַווע	מקבל־באַהבֿה
מעקאַבל־טײַנעג	מקבל־תּענוג
מעקאַבל־נאַכעס	מקבל־נחת
מעקאַבל־פּאָנעם	מקבל־פּנים
מעקאַבל־קיניען	מקבל־קנין
מעקאַבל־שאַבעס	מקבל־שבת
מעקאַבער	מקבר
מעקאַדעש	מקדש
מעקאַדעש־האַשעם	מקדש־השם
מעקאַטרייגים	מקטרגים
מעקאַטרעג	מקטרג
מעקאָכים	מקחים
מעקאַמעץ	מקמץ
מעקאַנע	מקנא
מעקאָנענים	מקוננים
מעקאַפּייעך	מקפּח
מעקאַצער	מקצר
מעקאַצער־יאָמים	מקצר־ימים
מעקאַצער־יאָמים־וועשאָנים	מקצר־ימים־ושנים
מעקאַצרים	מקצרים
מעקאַרעוו	מקרבֿ
מעקאַשע־ליילעד	מקשה־לילד
מעקובאָלים	מקובלים
מעקובל	מקובל
מעקוימעס	מקומות
מעקוינען	מקונן
מעקוּיעם	מקוים
מעקוירים	מקורים
מעקוירעס	מקורות
מעקוראָווים	מקורבֿים
מעקורעוו	מקורבֿ
מעקײַעם	מקיים
מעקײַעם־פּסאַק	מקיים־פּסק
מעקילים	מקילים
מעקעך	מקח
מעקעך־אומעמקער	מקח־וממכּר
מעקעך־טאָעס	מקח־טעות
מעראַגל	מרגל
מעראַכעם	מרחם
מעראַכעק	מרחק
מעראַמעז	מרמז
מערובאָיִם	מרובעים
מערובע	מרובה
מערובע	מרובע
מערויעך־אָשעך	מרוח־אָשך
מערוצע	מרוצה
מערוצע־לאַבריִעס	מרוצה־לבריות
מערטשעם	אם־ירצה־השם
מערידע	מרידה
מערידעס	מרידות
מעריינע	מורנו
מערכאַקים	מרחקים
מערכע־טיפּכע	מרכא־טיפּחא
מערכעץ	מרחץ
מערכעק	מרחק
מערצעשעם	אם־ירצה־השם
מערקאָווע	מרכּבֿה
מעשאַדעך	משדך
מעשאַכעד	משחד
מעשאַלייעך	משלח
מעשאָלים	משלים
מעשאַלעם	משלם
מעשאַלעמען	משלמען
מעשאַלשל־בעיאַד	משלשל־ביד
מעשאַמער־אומאַצל	משמר־ומציל
מעשאַמעש	משמש
מעשאַמעש־האַמיטע	משמש־המיטה
מעשאַמשים	משמשים
מעשאַנע	משנה
מעשאַנע־שעם	משנה־שם
מעשאַעל־אייצע	משאל־עצה
מעשאַער	משער
מעשאַקער	משקר
מעשאָרסים	משרתים
מעשאָרסיש	משרתיש
מעשאָרעס	משרת
מעשאָרעסטע	משרתטע
מעשאָרערים	משוררים
מעשובאָדע־קאָאָל	משועבדי־קהל
מעשובעד	משועבד
מעשוגאָיִם	משוגעים
מעשוגאַס	משוגעת
מעשוגן	משוגען
מעשוגע	משוגע
מעשוגע־לעדאָווער־עכעד	משוגע־לדבֿר־אחד
מעשוגענער	משוגענער
מעשוגענערהייט	משוגענערהייט
מעשוגענע	משוגענע
מעשוירער	משורר
מעשולאָכים	משולחים
מעשולאַכעס	משולחת
מעשולאָשים	משולשים
מעשולעך	משולח
מעשולעם	משולם
מעשולעש	משולש
מעשומאָדים	משומדים
מעשומעד	משומד
מעשומעדעס	משומדת
מעשומעדעסטע	משומדתטע
מעשונע	משונה
מעשופּע	משופּע
מעשופֿרע־דעשופֿרע	משופֿרי־דשופֿרי
מעשײַשייע	משעשע
מעשיכים	משיחים
מעשיכיש	משיחיש
מעשיכעס	משיחות
מעשיִעך	משיח
מעשיִעכס	משיחס
מעשיִעכן	משיחן
מעשיִעך בען־דאָוויד	משיח בן־דוד
מעשיִעך בען־יויסעף	משיח בן־יוסף
מעשיִעכל	משיחל
מעשעך	משך
מרויעך־אָשעך	מרוח־אָשך
נאָגעד	נגיד
נאָגעדס	נגידס
נאַדוואָנים	נדבֿנים
נאַדוואָנעס	נדבֿנות
נאַדוון	נדבֿן
נאַדוונטע	נדבֿנטע
נאַדן	נדן
נאָדעוו	נדיבֿ
נאָדעוו־האַיעדוע	נדיבֿ־הידוע
נאַהאַראָ נאַהאַראָ אופֿשאָטע	נהראָ נהראָ ופֿשטי
נאָווי	נבֿיא
נאַווענאַד	נע־ונד
נאַווענאַדניצע	נע־ונדניצע
נאַווענאַדניק	נע־ונדניק
נאָזער	נזיר
נאָיאַפֿים	נואפֿים
נאַך	נ״ך
נאַכזער לעיִניאָניינו	נחזור לענינינו
נאָכטאַם	נאָכטעם
נאַכלאָעס	נחלאָות
נאַכלע	נחלה
נאַכמען	נחמן
נאָכעם	נחום
נאַכעס	נחת
נאַכעס־רועך	נחת־רוח
נאָכעש	נחש
נאָכעש־האַקאַדמויני	נחש־הקדמוני
נאָלדים	נולדים
נאַמע	נעמי
נאָמע	נעמי
נאָסאָ	נשׂא
נאָסי	נשׂיא
נאָסן	נתן
נאָסנים	נותנים
נאַסענען	נתנען
נאָע	נאה
נאָע־דוירעש	נאה־דורש
נאָע־מעקײַעם	נאה־מקיים
נאַפֿטאָלע	נפֿתּלי
נאַפֿטאָלעס	נפֿתּליס
נאַפֿטאָלען	נפֿתּלין
נאַפֿקע	נפֿקא
נאַפֿקעמינע	נפֿקא־מינה
נאַצכאָנעס	נצחנות
נאַצערעס	נצרת
נאַקוועס	נקבֿות
נאָקי	נקי
נאַרע־האַמויראָסע	נערה־המאורשׂה
נאַרע־שעניספּאַטעסע	נערה־שניתפּתּתה
נאָשים	נשים
נאָשים־וועטאַף	נשים־וטף
נאָשים־ציטקאָניעס	נשים־צדקניות
נאָשים־צנועס	נשים־צנועות
נוטריקן	נוטריקון
נויגסים	נוגשׂים
נויגעס	נוגשׂ
נויטים־לאָמעס	נוטים־למות
נויטע	נוטה
נויטע־לאָמעס	נוטה־למות
נוילעד	נולד
נוילעד־מאָהעל	נולד־מהול
נוימע	נעמי
נויסים	נוסעים
נויסים	נושׂאים
נויסן	נותן
נויסע־האַמיטע	נושׂאי־המיטה
נויסע־כיין	נושׂא־חן
נויסענען	נותנען
נויסע־פּאָנעם	נושׂא־פּנים
נויסע־קיילים	נושׂא־כּלים
נויעג	נוהג
נויעג־קאָוועד	נוהג־כּבֿוד
נויעך	נח
נויעכס	נחס
נויעכן	נחן
נויעך־לעבריִעס	נוח־לבריות
נויעף	נואף
נויעפֿטע	נואפֿטע
נויעפֿים	נואפֿים
נויעפֿן	נואפֿן
נויפֿעך	נופֿך
נויפֿעך־מישעלאָ	נופֿך־משלה
נויפֿעך־מישעלוי	נופֿך־משלו
נויצרי	נוצרי
נויקסים	נוגשׂים
נויקעם	נוקם
נויקעם־ווענויטער	נוקם־ונוטר
נויקעם־ווענויטער־קענאָכעש	נוקם־ונוטר־כּנחש
נון	נ
נון	נון
נוסכאָעס	נוסחאָות
נוסעך	נוסח
נוסעך־אַשקענאַז	נוסח־אַשכּנז
נוסעך־האָאַרי	נוסח־האַר״י
נוסעך־ספֿאַרד	נוסח־ספֿרד
ניבלפּע	ניבול־פּה
ניגונים	ניגונים
ניגונימלעך	ניגונימלעך
ניגזאָלים	ניגזלים
ניגזל	ניגזל
ניגזער	ניגזר
ניגלע	ניגלה
ניגמער	ניגמר
ניגן	ניגון
ניגנדל	ניגונדל
נידה	נידה
ניווזים	ניבֿזים
ניווזע	ניבֿזה
ניווכאָרים	ניבֿחרים
ניווכער	ניבֿחר
ניוול־אומישטוימעם	ניבֿהל־ומשתּומם
ניוול־ווענישטוימעם	ניבֿהל־ונשתּומם
ניזעק	ניזוק
ניזעקן	ניזוקן
ניזער	ניזהר
ניטבאָיִם	ניתּבעים
ניטבע	ניתּבע
ניטכע	נידחה
ניידער	נדר
נײַסע־ווענישמע	נעשׂה־ונשמע
נייפֿעלע	נפֿלע
נייר	נר
ניירטאָמעד	נר־תּמיד
ניירע־יאָער	נ״י
ניירע־יאָער	נרו־יאיר
ניכבאָדים	ניכבדים
ניכבאָדע־האָיִר	ניכבדי־העיר
ניכבעד	ניכבד
ניכטאָווים	ניכתּבֿים
ניכטעוו	ניכתּבֿ
ניכלעל	ניכלל
ניכנאָיִם	ניכנעים
ניכנע	ניכנע
ניכע	ניחא
ניכעסע	ניחותא
ניכפּע	ניכפּה
ניכפּעניצע	ניכפּהניצע
ניכפּעניק	ניכפּהניק
ניכשל	ניכשל
נילע	נעילה
נימוסים	נימוסים
נימעס	נימאס
נימעס	נימוס
נימעס־אומאָעס	נימאס־ומאָוס
נימעס־אומיִעס	נימאס־ומיאוס
נימצע	נימצא
נימרעד	נמרוד
נימשאָלים	נימשלים
נימשל	נימשל
נינויִם	נענועים
ניסאַלע	נתעלה
ניסאַשער	נתעשר
ניסבאַקעש	נתבקש
ניסגאַדל	נתגדל
ניסגאַלע	נתגלה
ניסויען	נסיון
ניסטאַלעק	נסתּלק
ניסטאָרים	ניסתּרים
ניסטאָרעס	ניסתּרות
ניסטער	ניסתּר
ניסיוינעס	נסיונות
ניסים	נסים
ניסימדיק	נסימדיק
ניסים־וועניפֿלאָעס	נסים־ונפֿלאָות
ניסכאַמעץ	נתחמץ
ניסכײַעוו	נתחייבֿ
ניסן	ניסן
ניסע־ניסים	נסי־נסים
ניספּאָעל	נתפּעל
ניספּאַרסעם	נתפּרסם
ניסראַבע	נתרבה
ניסראָפֿים	נישׂרפֿים
ניסרעף	נישׂרף
ניִעף	ניאוף
ניפֿטאָרים	ניפֿטרים
ניפֿטער	ניפֿטר
ניפֿכאָרים	ניבֿחרים
ניפֿכער	ניבֿחר
ניפֿלע	ניפֿלא
ניצאָווים	נצבֿים
ניצאָכן	נצחון
ניצויצעס	ניצוצות
ניצכוינעס	נצחונות
ניצל	ניצול
ניצמעך	ניצמח
ניצעץ	ניצוץ
ניצראָכים	ניצרכים
ניצרעך	ניצרך
ניקעד	ניקוד
ניקער	ניכּר
נירדאָפֿים	נירדפֿים
נירדעף	נירדף
נישטאַנע	נשתּנה
נישטוימעם	נשתּומם
נישמאָסע בעגינזע־מערוימים	נשמתו בגנזי־מרומים
נישער	נישאר
נישקאָשע	נישקשה
נישקאָשעדיק	נישקשהדיק
נישקאָשעדיקער	נישקשהדיקער
נישקאָשעדיקע	נישקשהדיקע
נישקאָשעדיקן	נישקשהדיקן
נישקאָשעדיקס	נישקשהדיקס
נעגאָיִם	נגעים
נעגידים	נגידים
נעגידיש	נגידיש
נעגידישער	נגידישער
נעגידישע	נגידישע
נעגידישן	נגידישן
נעגידישקייט	נגידישקייט
נעגידע	נגידה
נעגידעס	נגידות
נעגידעסטע	נגידיתטע
נעגידעסטעס	נגידיתטעס
נעגייע	נוגע
נעגייע־באַדאָווער	נוגע־בדבֿר
נעגייע־בעקאָוועד	נוגע־בכּבֿוד
נעגינע	נגינה
נעגישעס	נגישות
נעגע	נגע
נעגעוו	נגבֿ
נעגען	נגען
נעגענען	נגענען
נעגע־צאָראַאַס	נגע־צרעת
נעדאָווע	נדבֿה
נעדאָוועס	נדבֿות
נעדאַן	נדן
נעדאָרים	נדרים
נעדוניע	נדוניא
נעדיווים	נדיבֿים
נעהאַר־די־נור	נהר־די־נור
נעהענע	נהנה
נעהענע־מיגיִע־קאַפּע	נהנה־מיגיע־כּפּו
נעוואָלע	נבֿלה
נעוווּכאַדנעצער	נבֿוכדנאצר
נעוווּכאַדנעצער	נבֿוכדנצר
נעוווּע	נבֿואה
נעוויילע	נבֿלה
נעוויילעס	נבֿלות
נעוויִיִם	נבֿיאים
נעוויִיִם־אוקסוּווים	נבֿיאים־וכּתובֿים
נעוויִיִם־אַכרוינים	נבֿיאים־אַחרונים
נעוויִיִם־רישוינים	נבֿיאים־ראשונים
נעוויירע	עבֿירה
נעוויירעס	עבֿירות
נעוויִיִש	נבֿיאיש
נעוויִע	נבֿיאה
נעוויִעטע	נבֿיאהטע
נעוויִעטעס	נבֿיאהטעס
נעוויִעס	נבֿיאות
נעזיפֿע	נזיפֿה
נעזיקן	נזיקין
נעזירים	נזירים
נעזירעס	נזירות
נעטילעס־יעדאַיִם	נטילת־ידים
נעטיִע	נטיה
נעטיִעס	נטיות
נעיִמעסדיק	נעימותדיק
נעכאָמע	נחמה
נעכאָמעס	נחמהס
נעכאָמען	נחמהן
נעכאַמע	נחמה
נעכאַמעס	נחמהס
נעכאַמען	נחמהן
נעכאָמעס	נחמות
נעכאָס־דאַרגע	נחות־דרגא
נעכאָסים	נכסים
נעכאָשים	נחשים
נעכבע־על־האַקיילים	נחבא־אל־הכּלים
נעכעמיע	נחמיה
נעכעמיעס	נחמיהס
נעכעמיען	נחמיהן
נעלאָמים	נעלמים
נעלם	נעלם
נעמאָנים	נאמנים
נעמאָנע	נאמנה
נעמאָנעס	נאמנות
נעמען	נאמן
נעמענטע	נאמנטע
נעמענטעס	נאמנטעס
נענאַטקע	ננתּקה
נענעש	נענש
נעס	נס
נעסאַנע־טויקעף	נתנה־תּוקף
נעס־בעטאָך־נעס	נס־בתּוך־נס
נעס גאָדויל הויאָ שאָם	נס גדול היה שם
נעס גאָדל הויאָ שאָם	נס גדול היה שם
נעסיִיִם	נשׂיאים
נעסייע	נוסע
נעסינע	נתינה
נעסיִע	נסיעה
נעסיִעס	נסיעות
נעס־מין־האַשאָמאַיִם	נס־מן־השמים
נעסעך	נסך
נעפֿאַשעס	נפֿשות
נעפֿאָשעס	נפֿשות
נעפֿיכע	נפֿיחה
נעפֿעש	נפֿש
נעפֿעש־אַכעס	נפֿש־אַחת
נעצעך	נצח
נעצעך־ייִסראָעל	נצח־ישׂראל
נעצער	נעצר
נעקאָווים	נקבֿים
נעקאָווים־גדוילים	נקבֿים־גדולים
נעקאָווים־קטאַנים	נקבֿים־קטנים
נעקאָמע	נקמה
נעקודים־אוּוורודים	נקודים־ובֿרודים
נעקודע	נקודה
נעקודעס	נקודות
נעקייווע	נקבֿה
נעקייוועס	נקבֿות
נעקיִעס	נקיות
נעקי־קאַפּאַיִם	נקי־כּפּים
נעקי־קאַפּאַיִמניק	נקי־כּפּימניק
נערעג	נהרג
נערעג־אַל־פּאָכעס־מישאָווע־פּרוטע	נהרג־על־פּחות־משווה־פּרוטה
נערעגן	נהרגן
נעשאָמע	נשמה
נעשאָמעס	נשמות
נעשאָמע־ליכט	נשמה־ליכט
נעשאָמע־יעסיירע	נשמה־יתירה
סאַגענאָער	סגי־נהור
סאַגענאָערטע	סגי־נהורטע
סאָד	סוד
סאַדיע	סעדיה
סאַדיע האַגאָען	סעדיה הגאון
סאַדיע גאָען	סעדיה גאון
סאָדע־סוידעס	סודי־סודות
סאַדערן	סדרן
סאַוולאָנים	סבֿלנים
סאַוולאָנעס	סבֿלנות
סאַוולען	סבֿלן
סאַוולענטע	סבֿלנטע
סאַוולענטעס	סבֿלנטעס
סאָווע	סבֿא
סאָטן	שׂטן
סאָטן־האַמאַשכעס	שׂטן־המשחית
סאָטן־האַמעקאַטרעג	שׂטן־המקטרג
סאָטן־מעקאַטרעג	שׂטן־מקטרג
סאָיִף	סעיף
סאַך	סך
סאַכאַקל	סך־הכּל
סאַך־האַקוילעל	סך־הכּולל
סאָכנוט	סוכנותּ
סאָכרים	סוחרים
סאָכרימלעך	סוחרימלעך
סאָכריש	סוחריש
סאָכרערײַ	סוחרערײַ
סאָלקאָ דייטאָך	סלקא דעתּך
סאַם	ס״ם
סאַם	סם
סאַם־אַמאָוועס	סם־המוות
סאַמאָעל	סמאל
סאַמבאַטיען	סמבטיון
סאַם־האַמאָוועס	סם־המוות
סאָמייעך־בעכעלקע	שׂמח־בחלקו
סאַמעך	ס
סאַמעך	סמך
סאַמעך־מעם	ס״ם
סאַמעך־מעם	סמך־מם
סאַמען	סמען
געסאַמט	געסמט
פֿאַרסאַמען	פֿאַרסמען
פֿאַרסאַמט	פֿאַרסמט
פֿאַרסאַמטער	פֿאַרסמטער
פֿאַרסאַמטע	פֿאַרסמטע
פֿאַרסאַמטן	פֿאַרסמטן
סאַנדאַלפֿן	סנדלפֿון
סאַנדעק	סנדק
סאַנדעקאָעס	סנדקאָות
סאַנייגער	סניגור
סאָנים	שׂונאים
סאַנעדרין	סנהדרין
סאַנעדרין־גדוילע	סנהדרין־גדולה
סאַנעדרין־קטאַנע	סנהדרין־קטנה
סאָסן־וועסימכע	שׂשׂון־ושׂימחה
סאָער־לאַזאָזל	שׂעיר־לעזאָזל
סאָף	סוף
סאָף	סוף־
סאָף	תוו
סאָף־קאָל־האַדוירעס	סוף־כּל־הדורות
סאָפֿעק	ספֿק
סאָפֿעקן	ספֿקן
סאָפֿקל־סאָף	סוף־כּל־סוף
סאָפֿרים	סופֿרים
סאָפֿריש	סופֿריש
סאָפֿרעס	סופֿרות
סאַפֿרע־ראַבע	ספֿרא־רבה
סאַקאָנע	סכּנה
סאַקאָנעס	סכּנות
סאַקאָנעס־נעפֿאָשעס	סכּנות־נפֿשות
סאַקן	סכּין
סאַר	שׂר
סאַר־האַמאַלכעס	שׂר־המלכות
סאַר־האַמאַשקים	שׂר־המשקים
סאַרטן	סרטן
סאָרים	שׂרים
סאַרכאָנים	סרחנים
סאַרכן	סרחן
סאַרכען	סרחען
סאַרכענען	סרחענען
סאַרסאָרים	סרסורים
סאַרסער	סרסור
סאַרסערן	סרסורן
סאָרע	שׂרה
סאָרעס	שׂרהס
סאָרען	שׂרהן
סאָרעלע	שׂרהלע
סאָרעלעס	שׂרהלעס
סאָרעלען	שׂרהלען
סאָרע באַס־טויווים	שׂרה בת־טובֿים
סאָרעד	שׂריד
סאָרעד־אופּאָלעט	שׂריד־ופּליט
סאָרע־האַמאַלכעס	שׂר־המלכות
סאָרעס	סריס
סאָרעף	שׂרף
סאַרפֿען	שׂרפֿען
סאַרפֿענען	שׂרפֿענען
סגאַן־לעוויִע	סגן־לויה
סדאָם	סדום
סדאָם־בעטל	סדום־בעטל
סדאָם־וואַאַמוירע	סדום־ועמורה
סדאָם־מישפּעט	סדום־מישפּט
סדאָרים	סדרים
סוג	סוג
סוגיע	סוגיא
סוגיעס	סוגיות
סודע	סעודה
סודעס	סעודות
סודע־האַמאַפֿסעקעס	סעודה־המפֿסקת
סודעס־האַווראָע	סעודת־הבֿראה
סודעס־מיצווע	סעודת־מיצווה
סודעס־פּורים	סעודת־פּורים
סוואַרבע	עשׂרים־ואַרבע
סוואָרע	סבֿרא
סוואָרע	סבֿרה
סוויווע	סבֿיבֿה
סוויוועס	סבֿיבֿות
סויגערן	סוגרן
סוידע	סודע
סוידען	סודען
סוידעסט	סודעסט
סוידעט	סודעט
געסוידעט	געסודעט
סוידעס	סודות
סוידעסדיק	סודותדיק
סוידעסדיקער	סודותדיקער
סוידעסדיקע	סודותדיקע
סוידעסדיקן	סודותדיקן
סוידעסדיקס	סודותדיקס
סוידעס־האַטוירע	סודות־התּורה
סויוול	סובֿל
סויטע	סוטה
סויכער	סוחר
סויכערס	סוחרס
סויכערל	סוחרל
סויכערטע	סוחרטע
סויכערטעס	סוחרטעס
סוילעס	סולת
סוימעך	סומך
סוימעך־נאָפֿלים	סומך־נופֿלים
סוינע	שׂונא
סוינעס	שׂונאס
סוינע־בעצע	שׂונא־בצע
סוינע־בעצע	שׂונאי־בצע
סוינעטע	שׂונאטע
סוינעטעס	שׂונאטעס
סוינע־ייִסראָעל	שׂונא־ישׂראל
סוינע־ייִסראָעל	שׂונאי־ישׂראל
סוינע־ציִען	שׂונא־ציון
סוינע־ציִען	שׂונאי־ציון
סויסער	סותר
סויפֿער	סופֿר
סויפֿערס	סופֿרס
סויפֿער־מאָהער	סופֿר־מהיר
סויפֿער־סטאַם	סופֿר־סתּ״ם
סוס	סוס
סוקע	סוכּה
סוקע־שער	סוכּה־שער
סוקעס	סוכּות
סטאַם	סתּ״ם
סטאַם	סתּם
סטימעס־האַגוילעל	סתּימת־הגולל
סטירע	סתּירה
סטירעס	סתּירות
סיִאַטע־דעשמײַע	סיעתּא־דשמעיא
סיבע	סיבה
סיבעס	סיבות
סיגופֿים	סיגופֿים
סיגנען	סיגנון
סיגעף	סיגוף
סידורים	סידורים
סידורימלעך	סידורימלעך
סידער	סידור
סידערל	סידורל
סידער־קידושן	סידור־קידושין
סידרע־בריישעס	סדרי־בראשית
סיוון	סיוון
סיטרע־אַכרע	סיטרא־אַחרא
סיטרע־בישע	סיטרא־בישא
סיטרע־דיסמאָלע	סיטרא־דשׂמאָלא
סיטרע־מעסאָוווּסע	סיטרא־מסאָבֿותא
סיידער	סדר
סיידער־אוילעם	סדר־עולם
סיידער־האָוילעם	סדר־העולם
סיידער־האַיאָם	סדר־היום
סיידערן	סדרן
סייכל	שׂכל
סייכל־האַיאָשער	שׂכל־הישר
סייפֿער	ספֿר
סייפֿער־פּראַלניק	ספֿר־פּראַלניק
סייפֿער־האַזיכרוינעס	ספֿר־הזכרונות
סייפֿער־האַיאָשער	ספֿר־הישר
סייפֿער־האַכאַיִם	ספֿר־החיים
סייפֿער־האַכאָסעם	ספֿר־החתום
סייפֿער־האַספֿאָרים	ספֿר־הספֿרים
סייפֿער־טוירע	ספֿר־תּורה
סייפֿער־יעצירע	ספֿר־יצירה
סייפֿער־כויל	ספֿר־חול
סייפֿער־כקירע	ספֿר־חקירה
סייפֿער־ראַזיל	ספֿר־רזיאל
סייפֿער־ראַזיִעל	ספֿר־רזיאל
סייפֿער־ראַזיל האַמאַלעך	ספֿר־רזיאל המלאך
סייפֿער־ראַזיִעל האַמאַלעך	ספֿר־רזיאל המלאך
סיכסוכים	סיכסוכים
סיכסעך	סיכסוך
סיכע	שׂיחה
סיכעס	שׂיחות
סיכעס־כולין	שׂיחת־חולין
סיכעס־נאָשים	שׂיחת־נשים
סילוקים	סילוקים
סילעק	סילוק
סילעקן	סילוקן
סימאָנים	סימנים
סימאָנים־מוּוואָקים	סימנים־מובֿהקים
סימאָנע־זאַכרעס	סימני־זכרות
סימאָנע־נאַאַרעס	סימני־נערות
סימכע	שׂימחה
סימכעס	שׂימחות
סימכע־וועסאָסן	שׂימחה־ושׂשׂון
סימכעס־בייס־האַשאָייווע	שׂימחת־בית־השואבֿה
סימכעס־טוירע	שׂימחת־תּורה
סימכעס־מיצווע	שׂימחת־מיצווה
סימכע־שעל־מיצווע	שׂימחה־של־מיצווה
סימען	סימן
סימען־דאַלעס	סימן־דלות
סימענטאָוו	סימן־טובֿ
סימען־מוּוועק	סימן־מובֿהק
סין	שׂ
סין	שׂין
סינײַ	סיני
סינײַדיק	סינידיק
סינײַ־ניגונים	סיני־ניגונים
סינײַ־ניגן	סיני־ניגון
סינע	שׂינאה
סינעס	שׂינאות
סינע סאַנסינע סעמאַנגלאָף	סיני סנסיני סמנגלוף
סינעס־כינעם	שׂינאת־חינם
סינעס־ציִען	שׂינאת־ציון
סיסרע־טוירע	סיתרי־תּורה
סיִעם	סיום
סיפּורים	סיפּורים
סיפּורע־מײַסעס	סיפּורי־מעשׂיות
סיפּורע־ניפֿלאָעס	סיפּורי־נפֿלאָות
סיפּער	סיפּור
סיפּער־האַמײַסע	סיפּור־המעשׂה
סיפּער־ניפֿלע	סיפּור־ניפֿלא
סיפֿרע־טוירע	ספֿרי־תּורה
סיפֿרע־כויל	ספֿרי־חול
סיפֿרע־כקירע	ספֿרי־חקירה
סיר־האַבאָסער	סיר־הבשׂר
סירכע	סירכא
סכאַך	סכך
סכאַקל	סך־הכּל
סכאַר	שׂכר
סכאַר־האַליכע	שׂכר־הליכה
סכאַר־וועוינעש	שׂכר־ועונש
סכאַר־טירכע	שׂכר־־טירחא
סכאַר־טירכע	שׂכר־טירחה
סכאָרים	זכרים
סכאַריע	זכריה
סכאַריעס	זכריהס
סכאַריען	זכריהן
סכאַר־לימעד	שׂכר־לימוד
סכאַר־מעלאָכע	שׂכר־מלאָכה
סכויר־בריס	זכור־ברית
סכוירע	סחורה
סכוירעס	סחורות
סכום	סכום
סכום־האַקוילעל	סכום־הכּולל
סכוס 	זכות
סכוסן	זכותן
סכוסים	זכותים
סכוס־אָוועס	זכות־אָבֿות
סכוס־אַצמע	זכות־עצמו
סכוס־האַקיִעם	זכות־הקיום
סכוסע יאָגן	זכותו יגן
סכוסע יאָגן אָליינו	זכותו יגן עלינו
סכוסעם יאָגן	זכותם יגן
סכוסעם יאָגן אָליינו	זכותם יגן עלינו
סכיִע	זכיה
סכיִעס	זכיות
סכיר־יאָם	שׂכיר־יום
סכירעס	שׂכירות
סליכע	סליחה
סליכעס	סליחות
סליכע־אומעכילע	סליחה־ומחילה
סליכענען	סליחהנען
סליכענער	סליחהנער
סמאַך	סמך
סמיכע	סמיכה
סמיכעס	סמיכות
סמיכעס־האַפּאַרשע	סמיכות־הפּרשה
סמיכעס־האַפּאַרשעס	סמיכות־הפּרשיות
סנע	סנה
סעגאַל	סג״ל
סעגינאָער	סגי־נהור
סעגינאָערדיק	סגי־נהורדיק
סעגינאָערטע	סגי־נהורטע
סעגל	סגול
סעדאָרים	סדרים
סעדרע	סדרה
סעדרעס	סדרות
סעו־יעדייכעם	שׂאו־ידיכם
סעיִפֿים	סעיפֿים
סעיִר	שׂעיר
סעכאַקל	סך־הכּל
סעלע־האַמאַכלויקעס	סלע־המחלוקת
סעמאַך	סמך
סעמאַנגלאָף	סמנגלוף
סעמעך	סמך
סענוי סאַנסענוי סעמאַנגלאָף	סנוי סנסנוי סמנגלוף
סעקאָנע	סכּנה
סעקאָנעס	סכּנות
סעקאָנעס־נעפֿאָשעס	סכּנות־נפֿשות
ספֿאַרד	ספֿרד
ספֿאַרדי	ספֿרדי
ספֿאַרדיס	ספֿרדית
ספֿאַרדיש	ספֿרדיש
ספֿאָרים	ספֿרים
ספֿאָרים־כיצוינים	ספֿרים־חיצונים
ספֿייקעס	ספֿקות
ספֿירע	ספֿירה
ספֿירעס	ספֿירות
ספֿירעס־האַנאָצרים	ספֿירת־הנוצרים
ספֿעק־ספֿייקע	ספֿק־ספֿקא
סקאָנים	זקנים
סקאָנע	זקנה
סקיינים	זקנים
סקיינע	זקנה
סקילע	סקילה
סראָכע	סרחה
סראָפֿים	שׂרפֿים
סראָפֿים־וועאויפֿאַנים	שׂרפֿים־ואופֿנים
סראָריש	שׂרריש
סראָרע	שׂררה
סראָרעס	שׂררות
סראָרעטע	שׂררהטע
סראָרעסטע	שׂררהסטע
סרידים	שׂרידים
סרידע־פּלייטע	שׂרידי־פּליטה
סרייפֿע	שׂרפֿה
סרייפֿעס	שׂרפֿות
סריסים	סריסים
סריסעס	סריסות
עגלע־אַרופֿע	עגלה־ערופֿה
עדוימי	אדומי
עדעם	אדום
עוויוינים	אבֿיונים
עוויויניש	אבֿיוניש
עוויוינעס	אבֿיונות
עוויען	אבֿיון
עוויענטע	אבֿיונטע
עוויענטעס	אבֿיונטעס
עוון־בויכן	אבֿן־בוחן
עוון	אבֿן
עוון־האָעזער	אבֿן־העזר
עוונטאָוו	אבֿן־טובֿ
עוון־נעגעף	אבֿן־נגף
עוון־פּעקודע	אבן־פּקודה
עוועד	עבֿד
עוועד־קנאַאַני	עבֿד־כּנעני
עוועד־קנײַני	עבֿד־כּנעני
עזרע	עזרא
עזרעס	עזראס
עזרען	עזראן
עזרע האַסויפֿער	עזרא הסופֿר
עזרעס־נאָשים	עזרת־נשים
עכאָד	אחד
עלאָ	אלא
עלאָזער	אלעזר
עלאָזערס	אלעזרס
עלאָזערן	אלעזרן
עלאָ מאַ 	אלא מאַי
עלאָ מאַ 	אלא מה
עלאָ מײַ	אלא מאַי
עלאָ מײַ	אלא מה
עליאָהו	אליהו
עליאָהוס	אליהוס
עליאָהון	אליהון
עליאָהו האַנאָווי	אליהו הנבֿיא
עליאָהו האַנאָוויס	אליהו הנבֿיאס
עליאָקעם	אליקום
עליוינים	עליונים
עלימיילעך	אלימלך
עליע	אליה
עליעס	אליהס
עליען	אליהן
עליעהאַנאָווע	אליהו הנבֿיא
עליעהאַנאָוועס	אליהו הנבֿיאס
עליעזער	אליעזר
עליעזערס	אליעזרס
עליעזערן	אליעזרן
עליען	עליון
עליענאָווע	אליהו הנבֿיא
עלישע	אלישע
עלישעס	אלישעס
עלישען	אלישען
עלישע בען־אַוווּיע	אלישע בן־אַבֿויה
עלכאָנען	אלחנן
עלכאָנענס	אלחננס
עלכאָנענען	אלחננען
עלע	אלא
עלעל	אלול
עלעלדיק	אלולדיק
עלע מאַ	אלא מאַי
עלע מאַ	אלא מה
עלע מײַ	אלא מאַי
עלע מײַ	אלא מה
עלעף	אלף
עלעף־אַלאָפֿים	אלף־אַלפֿים
עלעף־האַשישי	אלף־השישי
עלקאָנע	אלקנה
עמונע	אמונה
עמונעס	אמונות
עמונע־שליימע	אמונה־שלמה
עמעס	אמת
עמעס־וועיאַצעוו	אמת־ויציבֿ
עמעס מעערעץ טיצמעך	אמת מארץ תּצמח
עמעסן	אמתן
עמעסער	אמתער
עמעסע	אמתע
עמעסדיק	אמתדיק
עמעסדיקער	אמתדיקער
עמעסדיקע	אמתדיקע
עמעסדיקן	אמתדיקן
עמעסדיקס	אמתדיקס
עמער	אמור
ענקעס־מעסאַלדעכאָ	אנקת־מסלדיך
עסטער	אסתּר
עסטער האַמאַלקע	אסתּר המלכּה
עסטער־טאָנעס	אסתּר־תּענית
עסע	עשׂה
עסער־מאַקעס	עשׂר־מכּות
עסער־ספֿירעס	עשׂר־ספֿירות
עסרויגים	אתרוגים
עסרים־וואַרבע	עשׂרים־ואַרבע
עסרים־וועאַרבע	עשׂרים־ואַרבע
עסרעג	אתרוג
עסרעגל	אתרוגל
עפֿראָיִם	אפֿרים
עפֿראָיִמס	אפֿרימס
עפֿראָיִמען	אפֿרימען
עפֿרויכים	אפֿרוחים
עפֿרויעך	אפֿרוח
עפֿשער	אפֿשר
עצבע־עלאָקים	אצבע־אלוהים
עצבע־עלאָקים	אצבע־אלקים
עצבע־עלויהים	אצבע־אלוהים
עצעם	עצם
עצעם	עצם־
ערווע	ערווה
ערלטע	ערלטע
ערלטעס	ערלטעס
ערעוו	ערבֿ
ערעווראַוו	ערבֿ־רבֿ
ערעוו־שאַבעס	ערבֿ־שבת
ערעך	ערך
ערעץ	ארץ
ערעץ־ייִסראָעל	ארץ־ישׂראל
ערעץ־ייִסראָעל־פֿעדעם	ארץ־ישׂראל־פֿעדעם
ערקאָעס	ערכּאָות
פּאָגעם־קיילע	פּגום־כּלי
פּאָזער	פּזר
פּאַזראָנים	פּזרנים
פּאַזראָניש	פּזרניש
פּאַזראָנעס	פּזרנות
פּאַזרען	פּזרן
פּאַזרענטע	פּזרנטע
פּאַזרענטעס	פּזרנטעס
פּאַטעך	פּתּח
פּאָטער	פּטור
פּאָטער בעלוי קלום	פּטור בלא כּלום
פּאַטערן	פּטרן
פּאַטער	פּטר
פּאַטערסט	פּטרסט
פּאַטערסטו	פּטרסטו
פּאַטערט	פּטרט
געפּאַטערט	געפּטרט
געפּאַטערטער	געפּטרטער
געפּאַטערטע	געפּטרטע
געפּאַטערטן	געפּטרטן
פּאַטערנדיק	פּטרנדיק
פּאַטערניש	פּטרניש
פּאַטעש	פּטיש
פּאַכדאָנים	פּחדנים
פּאַכדאָניש	פּחדניש
פּאַכדאָנעס	פּחדנות
פּאַכדן	פּחדן
פּאַכדנטע	פּחדנטע
פּאַכדנטעס	פּחדנטעס
פּאַכעד	פּחד
פּאָכעס־מישאָווע־פּרוטע	פּחות־משווה־פּרוטה
פּאַלטיִעל	פּלטיאל
פּאָלעט	פּליט
פּאַלעציִען	פּועלי־ציון
פּאַמאַליע	פּמליא
פּאַמאַליע	פּמליה
פּאַמאַליע־שעל־מײַלע	פּמליא־של־מעלה
פּאַנו דערעך	פּנו דרך
פּאַנו מאָקעם	פּנו מקום
פּאָנעם	פּנים
 אַפּאָנעם	אַפּנים
פּאָנעם־כאַדאָשעס	פּנים־חדשות
פּאָנעם־כאַלאָשעס	פּנים־חלשות
פּאָנעם־על־פּאָנעם	פּנים־אל־פּנים
פּאַס־אַקום	פּת־עכּו״ם
פּאַס בעסאַלע	פּת בסלו
פּאָסל	פּסול
פּאַסלאָנעס	פּסלנות
פּאָסל־לעיידעס	פּסול־לעדות
פּאַסלען	פּסלען
פּאַסל	פּסל
פּאַסלסט	פּסלסט
פּאַסלט	פּסלט
געפּאַסלט	געפּסלט
פּאַסלענדיק	פּסלענדיק
פּאַסלעס	פּסלות
פּאַסעך	פּתח
פּאָסעק	פּסוק
פּאָסקים	פּוסקים
פּאָסקים־אַכרוינים	פּוסקים־אַחרונים
פּאָסקים־רישוינים	פּוסקים־ראשונים
פּאַסקען	פּסקען
פּאַסקן	פּסקן
פּאַסקנסט	פּסקנסט
פּאַסקנסטו	פּסקנסטו
פּאַסקנט	פּסקנט
פּאַסקענען	פּסקענען
געפּאַסקנט	געפּסקנט
פּאָסרים	פּותרים
פּאָקרים	פּוקרים
פּאַרדייסים	פּרדסים
פּאַרדעס	פּרדס
פּאָרויכעס	פּרוכת
פּאָרויכעסן	פּרוכתן
פּאָרכע־נישמאָסע	פּרחה־נשמתו
פּאַרנאָסים	פּרנסים
פּאַרנאָסע	פּרנסה
פּאַרנאָסעס	פּרנסות
פּאַרנאָסע־בזוּיע	פּרנסה־בזויה
פּאַרנאָסע־בעצימצעם	פּרנסה־בצימצום
פּאַרנאָסע־בעשעפֿע	פּרנסה־בשפֿע
פּאַרנייסים	פּרנסים
פּאַרנעס	פּרנס
פּאַרנעס־כוידעש	פּרנס־חודש
פּאַרנעס־כוידעשטע	פּרנס־חודשטע
פּאַרנעסע־כוידעש	פּרנסי־חודש
פּאָרע	פּרה
פּאַרע	פּרעה
פּאַרעס	פּרעהס
פּאָרע־אַדומע	פּרה־אַדומה
פּאָרעס	פּרס
פּאָרעס־האַבאָשן	פּרות־הבשן
פּאָרעץ	פּרוץ
פּאָרעץ	פּריץ
פּאָרעש	פּרוש
פּאַרצופֿים	פּרצופֿים
פּאָרצע־געדער	פּורצי־גדר
פּאַרצעף	פּרצוף
פּאַרצעף־פּאָנעם	פּרצוף־פּנים
פּאַרשע	פּרשה
פּאַרשעס	פּרשות
פּאַשטאָנים	פּשטנים
פּאַשטן	פּשטן
פּאָשטע־יאַד	פּושטי־יד
פּאַשטעס	פּשטות
פּאָשע־בעלויקיי־ייִסראָעל	פּושע־באלוקי־ישׂראל
פּאָשעט	פּשוט
פּאָשעטער	פּשוטער
פּאָשעטע	פּשוטע
פּאָשעטן	פּשוטן
פּאָשעטס	פּשוטס
פּאָשעט־קעמאַשמאָע	פּשוט־כּמשמעו
פּאָשע־ייִסראָעל	פּושע־ישׂראל
פּאָשע־ייִסראָעל	פּושעי־ישׂראל
פּאַשראָנים	פּשרנים
פּאַשרען	פּשרן
פּגאָיִם	פּגעים
פּגאָיִם־ראָיִם	פּגעים־רעים
פּגאַם	פּגם
פּגאָמים	פּגמים
פּגאָרים	פּגרים
פּגימע	פּגימה
פּגיריש	פּגיריש
פּגירע	פּגירה
פּויאַלים	פּועלים
פּויאַלע־ציִען	פּועלי־ציון
פּויגייע	פּוגע
פּויגייע־בעקאָוועד	פּוגע־בכּבֿוד
פּויגעם	פּוגם
פּויטיקע	אַפּותּיקא
פּויטיקע	אַפּותּיקי
פּויטיקע	פּותּיקא
פּויטיקע	פּותּיקי
פּוי־לין	פּה־לין
פּוילן	פּועלן
פּוי־ניטמען	פּה־ניטמן
פּוי־ניקבער	פּה־ניקבר
פּויסעק	פּוסק
פּויסעק־אַכרען	פּוסק־אַחרון
פּויסער	פּותר
פּויסער־כאָלעם	פּותר־חלום
פּויעל	פּועל
פּויעל־יויצע	פּועל־יוצא
פּויעלן	פּועלן
פּויעלסט	פּועלסט
פּויעלט	פּועלט
געפּויעלט	געפּועלט
פּויעלנדיק	פּועלנדיק
פּויעל־צעדעק	פּועל־צדק
פּויקעד־אַקאָרעס	פּוקד־עקרות
פּויקער	פּוקר
פּוירעץ־געדער	פּורץ־גדר
פּוירעש־בישמוי	פּורש־בשמו
פּוירעש־מין־האַציבער	פּורש־מן־הציבור
פּוישעט־יאַד	פּושט־יד
פּולע	פּעולה
פּולעס	פּעולות
פּוק	פּוק
פּוראָניעס	פּורעניות
פּורים	פּורים
פּורים־קאָטן	פּורים־קטן
פּורים־שפּיל	פּורים־שפּיל
פּורים־שפּילער	פּורים־שפּילער
פּורע	פּורה
פּטירע	פּטירה
פּטירעס	פּטירות
פּי	פּי
פּיגל	פּיגול
פּידיוינעס	פּדיונות
פּידיען	פּדיון
פּידיען־האַבען	פּדיון־הבן
פּידיען־האַנעפֿעש	פּדיון־הנפֿש
פּידיען־שוווּיִם	פּדיון־שבֿויים
פּיוו־האַקאָדעש	פּיו־הקדוש
פּיִוטים	פּיוטים
פּיזמוינים	פּיזמונים
פּיזמוינעס	פּיזמונות
פּיזמען	פּיזמון
פּיטעם	פּיטום
פּיטעם־האַקטוירעס	פּיטום־הקטורת
פּיי	פּ
פּיי	פּא
פּייגער	פּגר
פּייגערן	פּגרן
פּייגערסט	פּגרסט
פּייגערט	פּגרט
געפּייגערט	געפּגרט
פּייגערנדיק	פּגרנדיק
פּײַטאָנים	פּײַטנים
פּײַטן	פּײַטן
פּיילע	פּלא
פּייסעך	פּסח
פּייסעכדיק	פּסחדיק
פּייסעכדיקער	פּסחדיקער
פּייסעכדיקע	פּסחדיקע
פּייסעכדיקן	פּסחדיקן
פּייסעכדיקס	פּסחדיקס
פּייסעכיק	פּסחיק
פּייסעכיקער	פּסחיקער
פּייסעכיקע	פּסחיקע
פּייסעכיקן	פּסחיקן
פּייסעכיקס	פּסחיקס
פּייסעך־שיינע	פּסח־שני
פּייע	פּאה
פּייעלע	פּאהלע
פּייעלעך	פּאהלעך
פּייעס	פּאות
פּייעסלעך	פּאותלעך
פּײַעט	פּיוט
פּיירע	פּרי
פּיירעד־האַלוואָוועס	פּירוד־הלבֿבֿות
פּיירעס	פּרות
פּיירעס	פּירות
פּיירעק	פּרק
פּיירעש	פּירוש
פּיירעש־האַמילעס	פּירוש־המילות
פּילאַקשים	פּלגשים
פּילוסוף	פּילוסוף
פּילעגעש	פּלגש
פּילע־פּלאָיִם	פּילאי־פּלאָים
פּילפּל	פּילפּול
פּילפּלען	פּילפּולען
פּינכעס	פּינחס
פּינכעסעס	פּינחסעס
פּינכעסן	פּינחסן
פּינכעס	פּנחס
פּינכעסעס	פּנחסעס
פּינכעסן	פּנחסן
פּינכעס בען־עלאָזער בען־אַרן האַקויען	פּינחס בן־אלעזר בן־אַהרן הכּהן
פּינקאָסים	פּינקסים
פּינקייסים	פּינקסים
פּינקעס	פּינקס
פּיסכן־פּע	פּיתחון־פּה
פּיסעם־וועראַמסעס	פּיתום־ורעמסס
פּיסרוינים	פּיתרונים
פּיסרען	פּיתרון
פּיִעט	פּיוט
פּיקאָדן	פּקדון
פּיקדוינעס	פּקדונות
פּיקועך־נעפֿעש	פּיקוח־נפֿש
פּיקייעך	פּיקח
פּיקייעכטע	פּיקחטע
פּיקייעכטעס	פּיקחטעס
פּיקכים	פּיקחים
פּיקכעס	פּיקחות
פּיקכעס	פּיקחית
פּיקעך	פּיקח
פּיקעכטע	פּיקחטע
פּיקעכטעס	פּיקחטעס
פּירסעם	פּירסום
פּירקע־אָוועס	פּירקי־אָבֿות
פּכאָדים	פּחדים
פּכאָדימדיק	פּחדימדיק
פּכאָר	בכור
פּכאָרטע	בכורטע
פּכאָרטעס	בכורטעס
פּכוירים	בכורים
פּכוירע	בכורה
פּכוירעס	בכורות
פּכינע	בחינה
פּכינעס	בחינות
פּכיסעס־האַקאָוועד	פּחיתות־הכּבֿוד
פּכיִע	בכיה
פּכיִע־לעדוירעס	בכיה־לדורות
פּכיר	בחיר
פּכירע	בחירה
פּלאָיִם	פּלאָים
פּלוינע	פּלוני
פּלוינע־אַלמוינע	פּלוני־אַלמוני
פּלוינע־בען־פּלוינע	פּלוני־בן־פּלוני
פּלוינעס	פּלונית
פּלוינעס־באַס־פּלוינעס	פּלונית־בת־פּלונית
פּלוינעסטע	פּלוניתטע
פּלוינעסטעס	פּלוניתטעס
פּלוקטע	פּלוגתּא
פּלייטים	פּליטים
פּלייטע	פּליטה
פּלייטעס	פּליטות
פּליִע	פּליאה
פּליִעדיק	פּליאהדיק
פּלישטי	פּלישתּי
פּלישטים	פּלישתּים
פּניי	פּני
פּניי־האָיִר	פּני־העיר
פּנימיעס	פּנימיות
פּנינע	פּנינה
פּניִע	פּניה
פּסאָיִם	פּתאָים
פּסאָכים	פּסחים
פּסאַכיע	פּתחיה
פּסאַכיעס	פּתחיהס
פּסאַכיען	פּתחיהן
פּסאָמים	בשׂמים
פּסאָמים־ביקס	בשׂמים־ביקס
פּסאַק	פּסק
פּסאַק־געלט	פּסק־געלט
פּסאַקדין	פּסק־דין
פּסאָקים	פּסקים
פּסוילעס	פּסולת
פּסול	פּסול
פּסולים	בתולים
פּסולע	בתולה
פּסולעס	בתולות
פּסוקים	פּסוקים
פּסורע	בשׂורה
פּסורעס	בשׂורות
פּסורע־טויווע	בשׂורה־טובֿה
פּסורעס־טויוועס	בשׂורות־טובֿות
פּסורע־ראָע	בשׂורה־רעה
פּסורעס־ראָעס	בשׂורות־רעות
פּסיכען	פּתיחהן
פּסיכענען	פּתיחהנען
פּעאָמים	פּעמים
פּעגיריש	פּגיריש
פּעגע	פּגע
פּעגע־ראַ	פּגע־רע
פּעלע	פּלא
פּענעמל	פּנימל
פּענעמער	פּנימער
פּעסי	פּתי
פּעסי־יאַאַמען	פּתי־יאמין
פּע־עכעד	פּה־אחד
פּע־על־פּע	פּה־אל־פּה
פּער	פּאר
פּערושים	פּירושים
פּערע	פּרא
פּערעאָדעם	פּרא־אָדם
פּערעץ	פּרץ
פּקודע	פּקודי
פּראַט	פּרט
פּראַט־נאָמען	פּרט־נאָמען
פּראַט־נעמען	פּרט־נעמען
פּראָטים	פּרטים
פּראָיִם	פּראָים
פּראַס	פּרת
פּראַקדען	פּרקדן
פּראָקים	פּרקים
פּרוטע	פּרוטה
פּרוטעס	פּרוטות
פּרויזדער	פּרוזדור
פּרוצים	פּרוצים
פּרוצע	פּרוצה
פּרושים	פּרושים
פּרי־אייץ־האָדער	פּרי־עץ־הדר
פּריִע	פּריעה
פּריִע־אורוויִע	פּריה־ורבֿיה
פּריצטע	פּריצטע
פּריצטעס	פּריצטעס
פּריצים	פּריצים
פּריציש	פּריציש
פּריצע	פּריצה
פּריצעדיק	פּריצהדיק
פּריצעס	פּריצות
פּשאַט	פּשט
פּשאָטים	פּשטים
פּשאָיִם	פּשעים
פּשאָרע	פּשרה
פּשאָרעס	פּשרות
פּשוטע־קעמאַשמאָע	פּשוטו־כּמשמעו
פּשעטל	פּשטל
פּשעטלדיק	פּשטלדיק
פּשעטלען	פּשטלען
פֿאָצן	פֿצון
פֿאַראַקשענען	פֿאַרעקשנען
פֿאַרדווייקעט	פֿאַרדבֿקעט
פֿאַרדײַגעט	פֿאַרדאגהט
פֿאַרטאַכלעווען	פֿאַרתּכלעווען
פֿאַריאָסעמט	פֿאַריתומט
פֿאַריפּעשט	פֿאַרעיפּושט
פֿאַרכאַסמען	פֿאַרחתמען
פֿאַרכאַסמעט	פֿאַרחתמעט
פֿאַרכאַסמעטער	פֿאַרחתמעטער
פֿאַרכאַסמעטע	פֿאַרחתמעטע
פֿאַרכאַסמעטן	פֿאַרחתמעטן
פֿאַרכאַסמענען	פֿאַרחתמענען
פֿאַרכויווען	פֿאַרחובֿען
פֿאַרכוישעכט	פֿאַרחושכט
פֿאַרכושט	פֿאַרחושט
פֿאַרמאָרעשכוירעט	פֿאַרמרה־שחורהט
פֿאַרמאַשקענען	פֿאַרמשכּונען
פֿאַרמאַשקענען	פֿאַרמשכּנען
פֿאַרמויעכן	פֿאַרמוחן
פֿאַרמוישעווט	פֿאַרמושבֿט
פֿאַרמישפּעטן	פֿאַרמישפּטן
פֿאַרמישפּעט	פֿאַרמישפּט
פֿאַרסאַרפֿען	פֿאַרשׂרפֿען
פֿאַרפּייסעך	פֿאַרפּסח
פֿאַרקויסעט	פֿאַרכּוסעט
פֿאַרקישעפֿט	פֿאַרכּישופֿט
פֿאַרקנאַסן	פֿאַרקנסן
פֿאַרקנאַסט	פֿאַרקנסט
פֿאַרשיקערן	פֿאַרשיכּורן
פֿאַרשיקערט	פֿאַרשיכּורט
פֿאַרשעמט	פֿאַרשמט
פֿיי	פֿ
פֿיי	פֿא
צאַד	צד
צאַד־האַשאָווע	צד־השווה
צאַד־האַשוינע	צד־השונה
צאַדי	צדי
צאַדיקים	צדיקים
צאַדיקים־טמימים	צדיקים־תּמימים
צאַדיקע־האַדאָר	צדיקי־הדור
צאַדעק	צ
צאָדעק	צדוק
צאָדעקס	צדוקס
צאָדעקן	צדוקן
צאַדעק	צדיק
צאַדעק־האַדאָר	צדיק־הדור
צאַדעק־טאָמעם	צדיק־תּמים
צאָדקאָ מימעני	צדקה ממני
צאַד־שעקענעגדע	צד־שכּנגדו
צאַד־שעקענעגעד	צד־שכּנגד
צאָהאָלע	צהלה
צאָהאַלע־וועסאָמייכע	צהלה־ושׂמחה
צאַוו	צו
צאַוואָע	צואה
צאַוואָע	צוואה
צאַוואָעס	צוואָות
צאַלמאָוועס	צלמוות
צאַלעל	צלאל
צאַלעלס	צלאלס
צאַלעלן	צלאלן
צאַלעל	צלל
צאַלעלס	צללס
צאַלעלן	צללן
צאָם	צום
צאָמגעדאַליע	צום־גדליה
צאַנע־דימלע־סיפֿרע	צנא־דמלא־סיפֿרא
צאָן־קאָדאָשים	צאָן־קדשים
צאָפֿן	צפֿון
צאָץ	צץ
צאַר	צער
צאָראַאַס	צרעת
צאַר־אַיִן	צר־עין
צאַר־באַלעכאַיִם	צער־בעלי־חיים
צאַר־גידל־באָנים	צער־גידול־בנים
צאָרכע־ציבער	צרכי־ציבור
צאָרכע־ראַבים	צרכי־רבים
צאָרע	צרה
צאָרעס	צרות
צאָרעדיק	צרהדיק
צאָרעס־האַקלאַל	צרות־הכּלל
צאָרעס־ייִסראָעל	צרות־ישׂראל
צאָרעס־צרורעס	צרות־צרורות
צאָרעס־ראַבים	צרת־רבים
צאָרעס־ראַבים כאָצי־נעכאָמע	צרת־רבים חצי־נחמה
צאָרערים	צוררים
צאָרע־שעלוי־סאָוווי	צרה־שלא־תבֿוא
צדאָדים	צדדים
צדאָקע	צדקה
צדאָקעס	צדקות
צדאָקע־פּושקע	צדקה־פּושקע
צדאָקע־גדוילע	צדקה־גדולה
צדאָקע טאַצל מימאָוועס	צדקה תּציל ממוות
צדוקים	צדוקים
צוווּאַטשען	צבֿועטשען
צוווּאַטשקע	צבֿועטשקע
צוווּאַטשקעס	צבֿועטשקעס
צוווּאַק	צבֿועק
צוווּאַקעס	צבֿועקעס
צוווּיאַטשען	צבֿויאַטשען
צוווּיאַטשקע	צבֿויאַטשקע
צוווּיאַטשקעס	צבֿויאַטשקעס
צוווּיאַק	צבֿויאַק
צוווּיאַקעס	צבֿויאַקעס
צווי	צבֿי
צוויס	צבֿיס
צוויִעס	צבֿיעות
צוימייעך	צומח
צויע	צואה
צויער	צוהר
צוירעך	צורך
צוירער	צורר
צוירער־האַיעהודים	צורר־היהודים
צוירער־ייִסראָעל	צורר־ישׂראל
צופּאַסקען	צופּסקען
צופּאַסקענען	צופּסקענען
צורווע־דעראַבאָנען	צורבֿא־דרבנן
צורע	צורה
צורעס	צורות
צורעס־אַלעף	צורת־אַלף
צורעס־אָס	צורת־אות
צורעס־מאַטבייע	צורת־מטבע
ציבער	ציבור
ציבורים	ציבורים
צידעק־האַדין	צידוק־הדין
ציוויע	צבֿיה
ציִויני	ציוני
ציִוינעס	ציונות
ציִונים	ציונים
ציטקאָניעס	צדקניות
ציטקאָנעס	צדקנית
ציטקעס	צידקות
ציידע־לאַדערעך	צדה־לדרך
ציילעם	צלם
ציילעמניצע	צלמניצע
ציילעמניק	צלמניק
ציילעם־עלויהים	צלם־אלוהים
ציילעם־עלויקים	צלם־אלוקים
ציילעמען	צלמען
ציילעם־קאָפּ	צלם־קאָפּ
צייס־האַקויכאָווים	צאת־הכּוכבֿים
צייסכע־לעשאָלעם	צאתך־לשלום
צייסכעם־לעשאָלעם	צאתכם־לשלום
ציירופֿים	צירופֿים
ציירופֿע־אויסיעס	צירופֿי־אותיות
ציירע	צירי
ציירעף	צירוף
צימוקים	צימוקים
צימצעם	צימצום
צינוירעס	צינורות
צינער	צינור
ציִען	ציון
ציִעניזם	ציוניזם
ציִעניסט	ציוניסט
ציִעניסטס	ציוניסטס
ציִעניסטן	ציוניסטן
ציִעניסטיש	ציוניסטיש
ציִעניסטישער	ציוניסטישער
ציִעניסטישע	ציוניסטישע
ציִעניסטישן	ציוניסטישן
ציפּוירע	צפּורה
ציצע	ציצה
ציצעס	ציצות
ציצעס	ציצית
ציצע־קאַנפֿעס	ציצה־כּנפֿות
ציצע־קאַנפֿעסלעך	ציצה־כּנפֿותלעך
צלאָמים	צלמים
צמאָכים	צמחים
צנוע	צנועה
צנועדיק	צנועהדיק
צנועדיקער	צנועהדיקער
צנועדיקע	צנועהדיקע
צנועדיקן	צנועהדיקן
צנועדיקס	צנועהדיקס
צנועלע	צנועהלע
צנועס	צנועות
צניִעס	צניעות
צניִעסדיק	צניעותדיק
צניִעסדיקער	צניעותדיקער
צניִעסדיקע	צניעותדיקע
צניִעסדיקן	צניעותדיקן
צניִעסדיקס	צניעותדיקס
צעדאַמען	צעדמען
צעדייקעס	צדקת
צעדייקעסטע	צדקתטע
צעדעק	צדק
צעכושט	צעחושט
צעלאָכעס	צו להכעיס
צעלאָכעס	צולהכעיס
צעלאָכעסדיק	צולהכעיסדיק
צעלאָכעסניצע	צולהכעיסניצע
צעלאָכעסניק	צולהכעיסניק
צעמאַזעקן	צעמזיקן
צעמעך	צמח
צענערענע	צאינה־וראינה
צפֿאַניע	צפֿניה
צפֿאַס	צפֿת
צפֿאַרדייע	צפֿרדע
צראָכים	צרכים
קאָאָל	קהל
קאַאַלאָס	כּעלות
קאַאַלאָס־האַבויקער	כּעלות־הבוקר
קאַאַלאָס־האַשאַכער	כּעלות־השחר
קאָאָליש	קהליש
קאָאָלן	קהלן
קאָאָלס־מאַן	קהלס־מאַן
קאָאָלש	קהלש
קאַאַס	כּעס
קאַאַס־וועכיימע	כּעס־וחמה
קאַאַרע	קערה
קאַאַרעס	קערות
קאַבאָלע	קבלה
קאַבאָלעס	קבלות
קאַבאָלע־איִוניס	קבלה־עיונית
קאַבאָלע־מײַסיס	קבלה־מעשׂית
קאַבאָלעס־פּאָנעם	קבלת־פּנים
קאַבאָלעס־קיניען	קבלת־קנין
קאַבאָלעס־שאַבעס	קבלת־שבת
קאַבלו דאַטי	קבלו דעתּי
קאַבצאָנים	קבצנים
קאַבצאָניש	קבצניש
קאַבצאָנישער	קבצנישער
קאַבצאָנישע	קבצנישע
קאַבצאָנישן	קבצנישן
קאַבצאָנעס	קבצנות
קאַבצן	קבצן
קאַבצנטע	קבצנטע
קאַבצנטעס	קבצנטעס
קאַבצענען	קבצנען
קאַבראָנים	קברנים
קאַברען	קברן
קאַברענס	קברנס
קאַדאָכעס	קדחת
קאַדאָכעס־רעוויִעס	קדחת־רבֿיעית
קאַדאָכעס־שלישעס	קדחת־שלישית
קאָדאָשים	קדשים
קאָדאָשים־קאַלים	קדשים־קלים
קאַדיישים	קדישים
קאַדמוינים	קדמונים
קאַדמע־וועאַזלע	קדמא־ואזלא
קאַדמען	קדמון
קאַדער־האָאָרעץ	כּדור־האָרץ
קאָדעש	קדוש
קאַדעש	קדיש
קאָדעש־וועטאָהער	קדוש־וטהור
קאַדעשניק	קדישניק
קאָדשים	קדשים
קאָדשים־קאַלים	קדשים־קלים
קאָדשע־קאָדאָשים	קדשי־קדשים
קאָהיינע־וועכאָהיינע	כּהנא־וכהנא
קאַוואָנע	כּוונה
קאַוואָנעס	כּוונות
קאַוו־האַיאָשער	קבֿ־הישר
קאַוויאָכל	כּבֿיכול
קאָוועד	כּבֿוד
קאַזוואָנים	כּזבֿנים
קאַזוון	כּזבֿן
קאַזוונטע	כּזבֿנטע
קאַזוונטעס	כּזבֿנטעס
קאָזעוו	כּזבֿ
קאָזעוו־וועשעקער	כּזבֿ־ושקר
קאַט	כּתּ
קאַטאָוועס	כּתּבֿות
קאַט־דיליי	כּתּ־דיליה
קאָטוינטי	קטנתּי
קאַטייגער	קטיגור
קאַטייגערס	קטיגורס
קאַטלאָנים	קטלנים
קאַטלאַניעס	קטלניות
קאַטלאַנעס	קטלנית
קאַט־לייצאָנים	כּתּ־ליצנים
קאַטלען	קטלן
קאַטלע־קאַניע	קטלא־קניא
קאָטן	קטן
קאַטנעס־דעמויכן	קטנות־דמוחין
קאָיאַנים	כּהנים
קאָיאַנים־גדוילים	כּהנים־גדולים
קאַיאָר	כּאור
קאַיאָר	כּיאור
קאַיִן	קין
קאַך־האַווע	כּך־הווה
קאַך־הויע	כּך־היה
קאַך־וועקאַך	כּך־וכּך
קאָל	כּל־
קאָל	קול
קאַל	קל
קאָל־אַוווידעזאָרעס־שעבאָוילעם	כּל־עבֿודות־זרות־שבעולם
קאָל אוירעוו לעמינייהע	כּל עורבֿ למינהו
קאָלאַמינים	כּל־המינים
קאָלבוי	כּל־בו
קאָלבויניצע	כּל־בוניצע
קאָלבויניק	כּל־בוניק
קאָל־דאָווער־אָסער	כּל־דבֿר־אָסור
קאָל־דוואַר־שוירעש	כּל־דבֿר־שורש
קאָל־דיכפֿין	כּל־דכפֿין
קאָל־האַ…	כּל־ה…
קאָל־האַטויעוועס	כּל־התּועבֿות
קאָל־האַטוירע	קול־התּורה
קאָל־האַטוירע־קולע	כּל־התּורה־כּולה
קאָל־האַטײַמים	כּל־הטעמים
קאָל־האָן־דעאַלמע	כּל־הון־דעלמא
קאָל־האַפּאַסלאָנעס	כּל־הפּסלנות
קאָל־האַשוווּעס	כּל־השבֿועות
קאָל־האַפּאַסלאָנעס־שעבאָוילעם	כּל־הפּסלנות־שבעולם
קאָל־האַשוווּעס־שעבאָוילעם	כּל־השבֿועות־שבעולם
קאָל האַקוידעם זאָכע	כּל הקודם זכה
קאָל־הוין־דעאַלמע	כּל־הון־דעלמא
קאַלוועכוימער	קל־וחומר
קאָלוועלאָך	כּל־ולך
קאָלוועלאָכטע	כּל־ולכטע
קאָלו קאָל האַקיצן	כּלו כּל הקיצין
קאָלזמאַן	כּל־זמן
קאָלזמאַן שעהאַנעשאָמע בעקירבי	כּל־זמן שהנשמה בקירבי
קאָלזמאַן שעהאַנשאָמע בעקירבי	כּל־זמן שהנשמה בקירבי
קאָל־טוּוו	כּל־טובֿ
קאָל־טפֿוצעס־ייִסראָעל	כּל־תּפֿוצות־ישׂראל
קאָל־יאָכל	כּל־יכול
קאָל־יאָמײַ	כּל־ימי
קאָל־יאָמעוו	כּל־ימיו
קאָל־ייִסראָעל	כּל־ישׂראל
קאָל ייִסראָעל כאַוויירים	כּל ישׂראל חבֿרים
קאָל־יעמייהעם	כּל־ימיהם
קאָל־כאַמאָסאָ	כּל־חמתו
קאָל־כאַמאָסאָם	כּל־חמתם
קאָל־כאַמאָסע	כּל־חמתה
קאָל מאַמינים שעהו	כּל מאמינים שהוא
קאָל־מינע	כּל־מיני
קאָל־מעוואַסער	קול־מבֿשׂר
קאַלמען	קלמן
קאָלנידרע	כּל־נדרי
קאָל־נעגינע	קול־נגינה
קאַלע	כּלה
קאַלעס	כּלהס
קאַלע־מויד	כּלה־מויד
קאָלעלים	כּוללים
קאַלעס	קלות
קאַלעס־דאַאַס	קלות־דעת
קאַלעס־ראָש	קלות־ראָש
קאָלערליי	כּלערליי
קאַלפּע	קלפּי
קאַלפֿע	קלפֿי
קאָלקוירע	קול־קורא
קאָל־שוירעש־דאָווער	כּל־שורש־דבֿר
קאַל־שעבעקאַלים	קל־שבקלים
קאָלשקיין	כּל־שכּן
קאַמייע	קמיע
קאַמייעס	קמיעות
קאַמע	כּמה
קאַמע־וועקאַמע	כּמה־וכּמה
קאַמעס	כּמות
קאָמעץ	קמץ
קאַמצאָנים	קמצנים
קאַמצאָנעס	קמצנות
קאַמצן	קמצן
קאַמצנס	קמצנס
קאַמצנטע	קמצנטע
קאַמצנטעס	קמצנטעס
קאָמרים	כּומרים
קאַן	ק״ן
קאַנאָיִ	קנאָי
קאַנאָיִם	קנאָים
קאַנאָיִש	קנאָיש
קאַנאָיִשער	קנאָישער
קאַנאָיִשע	קנאָישע
קאַנאָיִשן	קנאָישן
קאַנאַל	כּנ״ל
קאַנאָעס	קנאָות
קאַן בויכן	כּאַן בוכין
קאַנסען	קנסען
קאַנסענען	קנסענען
קאָנע	קנה
קאָס	כּוס
קאַסווען	כּתבֿען
געקאַסוועט	געכּתבֿעט
קאַסווענען	כּתבֿענען
קאַסווע־ראַבע	כּתבֿא־רבא
קאָסעוו־וועכאָסעם	כּתובֿ־וחתום
קאַסריל	כּתריאל
קאַסריליק	כּתריאליק
קאַסרילעווקע	כּתריאלעווקע
קאַסרילעווקער	כּתריאלעווקער
קאַסריליק	כּתריליק
קאַסרילעווקע	כּתרילעווקע
קאַסרילעווקער	כּתרילעווקער
קאַסריִעל	כּתריאל
קאָף	כּ
קאָף	כּף
קאַפּאָרע	כּפּרה
קאַפּאָרעס	כּפּרות
קאַפּאָרע־הינדל	כּפּרה־הינדל
קאַפּאָרעניצע	כּפּרהניצע
קאַפּאָרעניצעס	כּפּרהניצעס
קאַפּדאָנים	קפּדנים
קאַפּדן	קפּדן
קאַפּצאָנים	קבצנים
קאַפּצאָנעס	קבצנות
קאַפּצן	קבצן
קאַפּצנטע	קבצנטע
קאַפּצענען	קבצנען
קאַף־האַקעלע	כּף־הקלע
קאַפֿאַקאַל	כּף־הקל
קאַפֿאַקל	כּף־הקל
קאַפֿטערן	כּפֿתּורן
קאָפֿל־שמוינע	כּפֿול־שמונה
קאָפֿל־שמוינעדיק	כּפֿול־שמונהדיק
קאָפֿע־טויווע	כּפֿוי־טובֿה
קאָפֿע־טויוועניק	כּפֿוי־טובֿהניק
קאָפֿרים	כּופֿרים
קאָפֿרים־בעיִקער	כּופֿרים־בעיקר
קאַפֿריסן	קפֿריסין
קאַפֿריסנדיק	קפֿריסינדיק
קאַצאָווים	קצבֿים
קאַצאָוויש	קצבֿיש
קאַצאָווישער	קצבֿישער
קאַצאָווישע	קצבֿישע
קאַצאָווישן	קצבֿישן
קאַצאָוועס	קצבֿות
קאָצן	קצין
קאַצעוו	קצבֿ
קאַצעווטע	קצבֿטע
קאַק	ק״ק
קאַקאָסעוו	כּכּתובֿ
קאָרבאָנעס	קרבנות
קאָרבן	קרבן
קאָרבן־מינכע	קרבן־מינחה
קאָרבן־מינכע־סידער	קרבן־מינחה־סידור
קאָרייסעס	כּריתות
קאָרים־אוקסאָסעס	כּרים־וכּסתות
קאָרעוו	קרובֿ
קאָרעווטע	קרובֿטע
קאָרעוו־לעמאַלכעס	קרובֿ־למלכות
קאָרעוו־לעמייקעך	קרובֿ־למקח
קאָרעוו־לעעמעס	קרובֿ־לאמת
קאָרעס	כּרת
קאַרפּעס	כּרפּס
קאַרקאָעס	קרקעות
קאַרקע	קרקע
קאַרקע־פּסולע	קרקע־בתולה
קאָשע	קשה
קאַשע	קשיא
קאַשעס	קשיות
קאַשעס	קשת
קאָשער	כּשר
קאָשערער	כּשרער
קאָשערע	כּשרע
קאָשערן	כּשרן
קאָשערס	כּשרס
קאָשערטאַנץ	כּשר־טאַנץ
קאָשער־וועיאָשער	כּשר־וישר
קאָשער־לעפּייסעך	כּשר־לפּסח
קאַשערן	כּשרן
געקאַשערט	געכּשרט
קאַשרעס	כּשרות
קדאָרים	קדרים
קדוישים	קדושים
קדוישים־אוטעהוירים	קדושים־וטהורים
קדושע	קדושה
קובוץ	קובוץ
קודשע־בעריך־הו	קודשא־בריך־הוא
קוואָד	כּבֿוד־
קוואָד־האַראַוו	כּבֿוד־הרבֿ
קוואַד־לאָשן	כּבֿד־לשון
קוואַטפּע	כּבֿד־פּה
קוואָרים	קבֿרים
קוואָרעס	קבֿרות
קוואָרעס־בלעטער	קבֿרות־בלעטער
קוואָרעס־ייִד	קבֿרות־ייִד
קוואָרעס־מאַן	קבֿרות־מאַן
קוואָרעס־שטיבל	קבֿרות־שטיבל
קוואָרעסניק	קבֿרותניק
קוווּרע	קבֿורה
קוווּרעס־ייִסראָעל	קבֿורת־ישׂראל
קוווּרעס־כאַמער	קבֿורת־חמור
קוויִעס	קבֿיעות
קוזרי	כּוזרי
קוזרים	כּוזרים
קוידעם	קודם
קוידעם־לאַקל	קודם־לכּל
קוידעמקאָל	קודם־כּל
קוידעש	קודש
קוידעש־קאָדאָשים	קודש־קדשים
קויהעלעס	קהלת
קויווייע	קובֿע
קויווער	קובֿר
קויכאָווים־אומאַזאָלעס	כּוכבֿים־ומזלות
קויכעס	כּוחות
קוילעל	כּולל
קוילעס	קולות
קוילעס־אוּווראָקים	קולות־ובֿרקים
קוילע־קוילעס	קולי־קולות
קוימעמיִעס	קוממיות
קוימער	כּומר
קוינים	קונים
קוינע	קונה
קוינע־אוילעם	קונה־עולם
קוינע־האַקל	קונה־הכּל
קוינעטע	קונהטע
קוינעטעס	קונהטעס
קוינע־סכוס	קונה־זכות
קוינע־שעם	קונה־שם
קויסל־מאַראָווי	כּותל־מערבֿי
קויסע	כּוסיע
קויסע	כּוסע
קויסעס	כּוסיעס
קויסעס	כּוסעס
קויסען	כּוסען
קויסענען	כּוסענען
קויסעס	כּוסות
קויעך	כּוח
קויעך־גאַוורע	כּוח־גבֿרא
קויעך־האַדאַם	כּוח־הדם
קויעך־האַדיבער	כּוח־הדיבור
קויעך־האַדימיען	כּוח־הדמיון
קויעך־האַמוישעך	כּוח־המושך
קויעך־האַמעדאַמע	כּוח־המדמה
קויעך־האַרשאָע	כּוח־הרשאה
קויעכן	כּוחן
קויען	כּהן
קויען־גאָדל	כּהן־גדול
קויענדיק	כּהנדיק
קויפֿעץ־בעראָש	קופֿץ־בראָש
קויפֿער	כּופֿר
קויפֿער־בעיִקער	כּופֿר־בעיקר
קויפֿער־האַקל	כּופֿר־הכּל
קויצע־שעליוד	קוצו־של־יוד
קוירייע	קורע
קוירייע־קעדאַג	קורע־כּדג
קוירים	כּורעים
קוירים־אומישטאַכווים	כּורעים־ומשתּחווים
קוירים־ניכבאָדים	קוראים־נכבדים
קוירעך	קורח
קוירעך	קרח
קוירע־ניכבעד	קורא־ניכבד
קוירעס־בריס	כּורת־ברית
קוירעש	כּורש
קולע	כּולו
קולע	קולא
קולע הײַ	כּולי האַי
קולע זאַקע	כּולו זכּאי
קולע טוירע	כּולה תּורה
קולע כײַעוו	כּולו חייבֿ
קולעם	כּולם
קולע מוקשע	כּולו מוקשה
קולע רעוועך	כּולו רווח
קונדייסים	קונדסים
קונדעס	קונדס
קונדעסערײַ	קונדסערײַ
קונטרייסים	קונטרסים
קונטרעס	קונטרס
קוף	ק
קוף	קוף
קופּע־שעל־שראָצים	קופּה־של־שרצים
קוצע־שעליוד	קוצו־של־יוד
קוש	כּוש
קזאָווים	כּזבֿים
קטאַניי־עמאָנע	קטני־אמנה
קטאַניי־עמונע	קטני־אמונה
קטאַנים	קטנים
קטוירעס	קטורת
קיבודים	כּיבודים
קיבוץ	קיבוץ
קיבוצים	קיבוצים
קיבעד	כּיבוד
קיבעד־אָוו	כּיבוד־אָבֿ
קיבעד־איים	כּיבוד־אם
קיבעץ	קיבוץ
קיבעץ־גאָליעס	קיבוץ־גלויות
קידושין	קידושין
קידושן	קידושין
קידעש	קדוש
קידעש	קידוש
קידעש־האַכוידעש	קידוש־החודש
קידעש־האַשעם	קידוש־השם
קידעש־לעוואָנע	קידוש־לבֿנה
קידעש־לעוואָנע־אויסיעס	קידוש־לבֿנה־אותיות
קי־הו־זע	כּי־הוא־זה
קיוון	כּיוון
קיזוּווים	כּיזובֿים
קיזעוו	כּיזובֿ
קיטניעס	קיטניות
קיטע	כּיתּה
קיטעס	כּיתּות
קיטרעג	קיטרוג
קיידער	קדר
קייווער	קבֿר
קייווער־אָוועס	קבֿר־אָבֿות
קייווער־ייִסראָעל	קבֿר־ישׂראל
קיילים	כּלים
קיילע	כּלי
קיילע־ניפֿלאָע	כּלי־נפֿלאה
קיילע־שיינע	כּלי־שני
קיילע־שליימע	כּלי־שלמה
קײַמעלאָן	קײַמא־לן
קײַסאָנים	כּעסנים
קייסאָרים	קיסרים
קײַסן	כּעסן
קײַסנטע	כּעסנטע
קײַסענען	כּעסנען
קייסער	קיסר
קייסער יאָרעם הוידע	קיסר ירום הודו
קייסעריניע	קיסריניע
קייסערינע	קיסרינע
קייע	קיאה
קייפֿל	כּפֿל
קייפֿלען	כּפֿלען
געקייפֿלט	געכּפֿלט
קייפֿל־קעפֿלאַיִם	כּפֿל־כּפֿלים
קײַרע	קערה
קײַרעס	קערות
קיירע	קרי
קילאַיִם	כּילאַים
קילאַכער־יאַד	כּלאַחר־יד
קילכויך־האַשאָר	כּלחוך־השור
קילעיאָדע	כּלא־ידע
קימאַט	כּמעט
קימכע־דעפּאַסכע	קמחא־דפּסחא
קינהאָג	כּנהוג
קיניאָנים	קנינים
קינים	כּינים
קינים	קינים
קיניען	קנין
קיניען־האַקאָאָל	קנין־הקהל
קינע	כּינה
קינע	קינאה
קינע	קינה
קינעס	קינות
קינע־סינע	קינאה־שׂינאה
קינעס־סאָפֿרים	קינאת־סופֿרים
קיס	כּיס
קיסים	כּיסים
קי־סאָוואָ	כּי־תבֿוא
קיסווע־האַקוידעש	כּיתבֿי־הקודש
קיסווע־יאַד	כּתבֿי־יד
קיסווע־פּלאַסטער	כּתבֿי־פּלסתּר
קי־סייצע	כּי־תצא
קי־סיסאָ	כּי־תישׂא
קיסלעוו	כּיסלו
קיסלער	כּיסלער
קיסע־האַמאַלכעס	כּיסא־המלכות
קיסע־האַקאָוועד	כּיסא־הכּבֿוד
קיסע־האַראַבאָנעס	כּיסא־הרבנות
קיסע־האַראַכמים	כּיסא־הרחמים
קיסע־ראַבאָנעס	כּיסא־רבנות
קיסע־שעל־עליאָהו	כּיסא־של־אליהו
קיסע־שעל־עליאָהו האַנאָווי	כּיסא־של־אליהו הנבֿיא
קיסריִיִם	קיסרים
קיִעם	קיום
קיִעם־האָומע	קיום־האומה
קיִער	כּיור
קיצווע	קיצבֿה
קיצורים	קיצורים
קיצער	קיצור
קיצער־האַדאָווער	קיצור־הדבֿר
קיצער־האַמײַסע	קיצור־המעשׂה
קיצער־יאָמים	קיצור־ימים
קיקויען־דעיוינע	קקיון־דיונה
קיקער־לעכעם	כּיכּר־לחם
קירכויק־מיזרעך־מימײַרעוו	כּרחוק־מיזרח־ממערבֿ
קירע	קיר״ה
קירע־דײַטש	קיר״ה־דײַטש
קישופֿים	כּישופֿים
קישעף	כּישוף
קישעפֿן	כּישופֿן
קישרוינעס	כּישרונות
קישרען	כּישרון
קלאַווטע	כּלבֿטע
קלאַווטעס	כּלבֿטעס
קלאָווים	כּלבֿים
קלאַל	כּלל
קלאַל־איניאָנים	כּלל־ענינים
קלאַל־זאַך	כּלל־זאַך
קלאַל־זאַכן	כּלל־זאַכן
קלאַל־טוער	כּלל־טוער
קלאַל־טוערס	כּלל־טוערס
קלאַל־ייִדיש	כּלל־ייִדיש
קלאַל־ייִסראָעל	כּלל־ישׂראל
קלאָלים	כּללים
קלאַליִעס	כּלליות
קלאָלע	קללה
קלאָלעס	קללות
קלאָלען	קללהן
קלאָלעס־אוכראָמעס	קללות־וחרמות
קלאָלעס־כראָמעס	קללות־חרמות
קלאָלעס־נימראָצעס	קללות־נימרצות
קלאַל־שפּראַך	כּלל־שפּראַך
קלאַל־שפּראַכן	כּלל־שפּראַכן
קלאַסטער־פּאָנעם	קלסתּר־פּנים
קלאַפּע	כּלפּי
קלאַפּע־כוץ	כּלפּי־חוץ
קלאַפּע־פּנים	כּלפּי־פּנים
קלאַפֿטע	כּלבֿטע
קלאַפֿטעס	כּלבֿטעס
קלאָץ־קאַשע	קלאָץ־קשיא
קלוימער	כּלומר
קלוימערשט	כּלומרשט
קלוינעמעס	קלונימוס
קליינשאַס	קליין־ש״ס
קלימעפֿויער	כּלי־מפֿואר
קליפּע	קליפּה
קליפּעס	קליפּות
קלע־באַיִס	כּלי־בית
קלע־זאָהאָוו	כּלי־זהבֿ
קלע־זאַיִן	כּלי־זיין
קלעזמאָרים	כּלי־זמרים
קלעזמער	כּלי־זמר
קלעזמערײַ	כּלי־זמרײַ
קלעזמערן	כּלי־זמרין
קלע־יאָקער	כּלי־יקר
קלע־מאַשכיס	כּלי־משחית
קלע־קוידעש	כּלי־קודש
קלע־קסיווע	כּלי־כּתיבֿה
קלע־קעסעף	כּלי־כּסף
קמוי	כּמו
קנאַאַן	כּנען
קנאַס	קנס
קנאַס־מאָל	קנס־מאָל
קנאָסים	קנסים
קנוניע	קנוניא
קנופֿיע	כּנופֿיא
קנופֿיע	כּנופֿיה
קניִע	קניה
קנעסעט	כּנסתּ
קנעסעס־האַגדוילע	כּנסת־הגדולה
קנעסעס־ייִסראָעל	כּנסת־ישׂראל
קסאַוו	כּתבֿ
קסאַוויאַד	כּתבֿ־יד
קסאַוויאַדן	כּתבֿ־ידן
קסאָווים	כּתבֿים
קסאַוו־פּלאַסטער	כּתבֿ־פּלסתּר
קסאַוו־ראַבאָנעס	כּתבֿ־רבנות
קסאָרים	כּתרים
קסובע	כּתובה
קסובעס	כּתובות
קסוּווים	כּתובֿים
קסיוו	כּתיבֿ
קסיוויש	כּתיבֿיש
קסיווע	כּתיבֿה
קסיווע וועכסימע טויווע	כּתיבֿה וחתימה טובֿה
קסיווען	כּתיבֿהן
קסיסע	גסיסה
קע…	כּ…
קעאַל־קאַף־האַיאַד	כּעל־כּף־היד
קעאָני־באַפּעסעך	כּעני־בפּתח
קעאַפֿרע־דעאַרע	כּעפֿרא־דאַרעא
קעאָר	כּאור
קעאָר־האַבויקער	כּאור־הבוקר
קעדאַיִק	כּדאַיִק
קעדאַס	כּדת
קעדאַס־מוישע־וויסראָעל	כּדת־משה־וישׂראל
קעדאַרקע	כּדרכּה
קעדאַרקע	כּדרכּו
קעדוימע	כּדומה
קעדוימע־לעמאָשל	כּדומה־למשל
קעדײַ	כּדאַי
קעדיי	כּדי
קעדין	כּדין
קעדין־אוקעדאַס	כּדין־וכּדת
קעדין־וועקעדאַס	כּדין־וכּדת
קעדעבאָע	כּדבעי
קעדערעך־האַטעווע	כּדרך־הטבֿע
קעהאַווײַע	כּהוויה
קעהאַלאָכע	כּהלכה
קעהאַל־כאַסידים	קהל־חסידים
קעהאַל־כסידים	קהל־חסידים
קעהאַנים	כּהנים
קעהונע	כּהונה
קעהײַ־לישנע	כּהאַי־לישנא
קעהילע	קהילה
קעהילעס	קהילות
קעהילע־קדוישע	קהילה־קדושה
קעזאַיִס	כּזית
קעזייסים	כּזיתים
קעזעוו	כּזבֿ
קעיאַד־האַגוויר	כּיד־הגבֿיר
קעיאַד־האַמיילעך	כּיד־המלך
קעיִלע	כּאילו
קעיעדוע	כּידוע
קעכוט־האַסיירע	כּחוט־השׂערה
קעכויל־האַיאַם	כּחול־הים
קעכוימער בעיאַד־האַיויצער	כּחומר ביד־היוצר
קעכערעס־האַנישבער	כּחרס־הנישבר
קעכצאָס־האַלײַלע	כּחצות־הלילה
קעלאָס־האַנעפֿעש	כּלות־הנפֿש
קעלוי־הויע	כּלא־היה
קעלכל	קולכל
קעלעוו	כּלבֿ
קעלעוו־שעבאַקלאָווים	כּלבֿ־שבכּלבֿים
קעלעכל	קולעכל
קעלער	קולער
קעמוּוון	כּמובֿן
קעמוּוון־מעיילעוו	כּמובֿן־מאליו
קעמיילעך־ביגדוד	כּמלך־בגדוד
קעמינהאָגע	כּמינהגה
קעמינהאָגע	כּמינהגו
קעמיקעדעם	כּמקדם
קעמעך־פּייסעך	קמח־פּסח
קענאָהעג	כּנהוג
קען־יאָוודו	כּן־יאָבֿדו
קען־ייִרבו	כּן־ירבו
קעניסקער לעייל	כּניזכּר לעיל
קענעגדים	כּנגדים
קענעגעד	כּנגד
קענציפּער	קן־ציפּור
קעסיידער	כּסדר
קעסעף	כּסף
קעסעף־טאָהער	כּסף־טהור
קעסער	כּתר
קעעכאָד־האָאָדעם	כּאחד־האָדם
קעעכאָד־האָרייקים	כּאחד־הריקים
קעפּשוטע	כּפּשוטו
קעפֿי	כּפֿי
קעץ	קץ
קעצאַפּיכעס־בידוואָש	כּצפּיחית־בדבֿש
קעץ־האַיאָמען	קץ־הימין
קעצוין־בלי־רויע	כּצאן־בלי־רועה
קעצוין־בעלי־רויע	כּצאן־בלי־רועה
קעקליפּעס־האַשום	כּקליפּת־השום
קעקעלע־קאָאָל	ק״קעלע־קהל
קעקריִעס־יאַמסוף	כּקריעת־ים־סוף
קערי	קרי
קערן	קרן
קערן־קאַיעמעס	קרן־קימת
קערעך	כּרך
קערעף־אַיִן	כּהרף־עין
קעשורע	כּשורה
קעשער	קשר
קפּיידע	קפּידא
קפּיידע	קפּידה
קפֿוּיע־טויווע	כּפֿוי־טובֿה
קפֿיצעס־האַדערעך	קפֿיצת־הדרך
קפֿירע	כּפֿירה
קצינים	קצינים
קראָיִ	קראָי
קראַך	כּרך
קראָכים	כּרכים
קראָשים	קרשים
קרוּוו	כּרובֿ
קרוז	כּרוז
קרויווים	קרובֿים
קרויווים־לעמאַלכעס	קרובֿים־למלכות
קרויווישאַפֿט	קרובֿישאַפֿט
קרויווע	קרובֿה
קרויוועטע	קרובֿהטע
קרויוועטעס	קרובֿהטעס
קרוע־אוּוולוע	קרועה־ובֿלויה
קרוע־בלוע	קרוע־בלוע
קרי	קרי
קרייוועס	קרבֿות
קרײַע־דאַבועדיק	כּרעיה־דאַבוהדיק
קריִע	קריעה
קריִעס־האַטוירע	קריאת־התּורה
קריִעס־יאַמסוף	קריעת־ים־סוף
קרירע	קרירה
קרישמע	קריאת־שמע
קשאַל־בערעך	כּשל־ברך
קשאָמים	גשמים
קשי־אוירעף	קשי־עורף
קשיי־אוירעף	קשה־עורף
קשיירים	כּשרים
ראַבאָנים	רבנים
ראַבאָניש	רבניש
ראַבאָנען־קאַדעש	רבנן־קדיש
ראַבאָנעס	רבנות
ראַבויסײַ	רבותי
ראַבויסים	רבותים
ראַביינו	רבנו
ראַביינו טאַם	רבנו תּם
ראַביינו טאַמס טפֿילן	רבנו תּמס תּפֿילין
ראַבים	רבים
ראַבע באַר־באַר־כאָנע	רבה בר־בר־חנה
ראַבע באַר־באַר־כאָנע	רבא בר־בר־חנה
ראַבעיִם	רביים
ראַבעיִש	רבייִש
ראַגזאָנים	רגזנים
ראַגזאָנעס	רגזנות
ראַגזן	רגזן
ראַגזנטע	רגזנטע
ראַגזנטעס	רגזנטעס
ראָגל	רגיל
ראַגלאַיִם	רגלים
ראָדפֿע־קאָוועד	רודפֿי־כּבֿוד
ראָדפֿע־שאָלעם	רודפֿי־שלום
ראָוו	רבֿ
ראָווס	רבֿס
ראַוו	רבֿ
ראָוו	רובֿ
ראָווביניען־וועראָווקיניען	רובֿ־בנין־ורובֿ־קנין
ראָווגאָדלע־וועראָוואָשרע	רובֿ־גדלו־ורובֿ־עשרו
ראָוו־דייעס	רובֿ־דעות
ראַוו־האַקוילעל	רבֿ־הכּולל
ראַוו־האָראָשי	רבֿ־הראָשי
ראָוומיניען־וועראָווביניען	רובֿ־מנין־ורובֿ־בנין
ראָוו־קאָס	רובֿ־כּוס
ראַזיעל	רזיאל
ראָזן־דעראָזן	רזין־דרזין
ראָטפֿע־קאָוועד	רודפֿי־כּבֿוד
ראָטפֿע־שאָלעם	רודפֿי־שלום
ראַיאָסי	רעיתי
ראַיאָסע	רעיתו
ראַיוינעס	רעיונות
ראַכאַש	רח״ש
ראַך־האַנוילעד	רך־הנולד
ראַך־האַנימל	רך־הנימול
ראַכוועס	רחבֿות
ראַכוועסדיק	רחבֿותדיק
ראַכוועסדיקער	רחבֿותדיקער
ראַכוועסדיקע	רחבֿותדיקע
ראַכוועסדיקן	רחבֿותדיקן
ראַכוועסדיקס	רחבֿותדיקס
ראַכוועסדיקייט	רחבֿותדיקייט
ראָכל	רחל
ראָכלס	רחלס
ראָכלען	רחלן
ראָכעלע	רחלע
ראָכעלעס	רחלעס
ראָכעלען	רחלען
ראַך־לעוו	רך־לבֿ
ראַכמאָנים	רחמנים
ראַכמאָנע־יעציליינע	רחמנא־יצילינו
ראַכמאָנע־ליצלאַן	רחמנא־לצלן
ראַכמאָנעס	רחמנות
ראַכמאָנעס־פּאָנעם	רחמנות־פּנים
ראַכמאָנעס־פּענעמער	רחמנות־פּנימער
ראַכמיל	רחמיאל
ראַכמים	רחמים
ראַכמיִעל	רחמיאל
ראַכמיִעלס	רחמיאלס
ראַכמיִעלן	רחמיאלן
ראַכמען	רחמן
ראָכעוו	רחבֿ
ראָכעוו האַזוינע	רחבֿ הזונה
ראַכעם	רחום
ראַכעם־וועכאַנען	רחום־וחנון
ראָכעק	רחוק
ראַמאָיִם	רמאָים
ראַמאַך	רמ״ח
ראַמאַך אייוורים	רמ״ח אבֿרים
ראַמאָעס	רמאָות
ראַמבאַם	רמבם
ראַמבאַם	רמב״ם
ראַמײַ	רמאַי
ראָע	ראָוי
ראָע	רעה
ראָע־לעהויראָע	ראָוי־להוראה
ראָע־לעכופּע	ראָוי־לחופּה
ראָפֿע	רפֿה
ראַצכאָנים	רצחנים
ראָצכים	רוצחים
ראַצכן	רצחן
ראַצכען	רצחען
ראַצכענען	רצחענען
ראָצן	רצון
ראַק	רק
ראָש	רא״ש
ראָש	ראָש
ראַש	רעש
ראָשאַקאָאָל	ראָש־הקהל
ראָש־בעזדן	ראָש־בית־דין
ראָש־בעזן	ראָש־בית־דין
ראָש־האַגוילע	ראָש־הגולה
ראָש־האַדאַיאָנים	ראָש־הדיינים
ראָש־האַמעדאַברים	ראָש־המדברים
ראָש־ווערישן	ראָש־וראשון
ראָשייטע	רשעטע
ראָשיעשיווע	ראָש־ישיבֿה
ראַשן	רעשן
געראַשט	גערעשט
ראַשע	רשי
ראַשעס	רשיס
ראַשע	רש״י
ראַשעס	רש״יס
ראָשע	רשע
ראָשע־בעזדן	ראָש־בית־דין
ראָשע־בעזן	ראָש־בית־דין
ראָשע־גאָמער	רשע־גמור
ראָשע־האַגוילע	ראָשי־הגולה
ראָשע־האַמעדאַברים	ראָשי־המדברים
ראָשעטייוועס	ראָשי־תּיבֿות
ראָשעטע	רשעטע
ראָשע־יעשיוועס	ראָשי־ישיבֿות
ראָשע־מערושע	רשע־מרושע
ראָשעפּראָקים	ראָשי־פּרקים
ראָשעקאָאָל	ראָשי־הקהל
ראַשע־קסאַוו	רשי־כּתבֿ
ראָשעשאָנע	ראָש־השנה
רובל־קעסעף	רובל־כּסף
רוגזע	רוגזא
רוגזע	רוגזה
רוּוון	ראובֿן
רוּוונס	ראובֿנס
רויגעז	רוגז
רוידעף־קאָוועד	רודף־כּבֿוד
רוידעף־שאָלעם	רודף־שלום
רוידעף־שאָלעמניק	רודף־שלומניק
רוידעפֿן	רודפֿן
גערוידעפֿט	גערודפֿט
רויע־וועיינע־נירע	רואה־ואינו־ניראה
רויע־כעזשבם	רואה־חשבון
רויפֿים	רופֿאים
רויפֿע	רופֿא
רויפֿעס	רופֿאס
רויפֿעטע	רופֿאטע
רויפֿעטעס	רופֿאטעס
רויפֿע־כוילים	רופֿא־חולים
רוישי־ווערובי	ראשי־ורובי
רוישע־ווערובע	ראשו־ורובו
רוישעם	רושם
רוכניִעס	רוחניות
רוכעס	רוחות
רוכעס־ראָיִם	רוחות־רעים
רוכעס־ראָעס	רוחות־רעות
רוס	רות
רועך	רוח
רועך־האַכאַיִם	רוח־החיים
רועך־האַקוידעש	רוח־הקודש
רועך־כאַיִם	רוח־חיים
רועך־ראַ	רוח־רע
רועך־ראָע	רוח־רעה
רועך־שטוס	רוח־שטות
ריבוינע־דעאַלמע	רבונא־דעלמא
ריבוינע־דעאַלמע־קולע	רבונא־דעלמא־כּולא
ריבעס	ריבית
ריבעסניק	ריביתניק
ריווקע	רבֿקה
ריווקעס	רבֿקהס
ריווקען	רבֿקהן
ריווקעלע	רבֿקהלע
ריווקעלעס	רבֿקהלעס
ריווקעלען	רבֿקהלען
רייכעס	ריחות
רײַע	ראַיה
רײַעס	ראַיות
רייע	ריאה
רייעך	ריח
רייעך־טוירע	ריח־תּורה
רייעך־ניכויעך	ריח־ניחוח
רײַע־לעדאָווער	ראַיה־לדבֿר
רײַען	רעיון
רײַעס־ברורעס	ראַיות־ברורות
רייק	ריק
רייש	ר
רייש	ריש
רייש־גאָלוסע	ריש־גלותא
ריישעס	ראשית
ריישעס־דאָווער	ראשית־דבֿר
ריישעס־כאָכמע	ראשית־חכמה
ריסעק־אייוורים	ריסוק־אבֿרים
ריִע	ראיה
ריפֿקע	רבֿקה
ריקודים	ריקודים
ריקעד	ריקוד
רישוינים	ראשונים
רישן	ראשון
רישעס	רישעות
רעב	ר׳
רעב	רב
רעבוינע־שעלוילעם	רבונו־של־עולם
רעביסטווע	רביסטווע
רעבע	רבי
רעבעס	רביס
רעבם	רבין
רעבמס	רבינס
רעבע־געלט	רבי־געלט
רעבעניו	רביניו
רעבעצן	רביצין
רעבעצנס	רביצינס
רעבעש	רביש
רעבעשאַפֿט	רבישאַפֿט
רעגאָלים	רגלים
רעגילים	רגילים
רעגילעס	רגילות
רעגל	רגל
רעגע־קעמעמרע	רגע־כּמימרא
רעגע	רגע
רעדיפֿע	רדיפֿה
רעדיפֿעס	רדיפֿות
רעוואָכים	רווחים
רעוווּסע	רבֿותא
רעוויִיִ	רבֿיעי
רעוול	רבֿל
רעוועך	רווח
רעיי	ראה
רעכאַש	רח״ש
רעכילעס	רכילות
רעכילעסן	רכילותן
רעכילעסניצע	רכילותניצע
רעכילעסניק	רכילותניק
רעמאָ	רמ״א
רעמאָזים	רמזים
רעמאַך	רמ״ח
רעמאַך אייוורים	רמ״ח אבֿרים
רעמעז	רמז
רעפֿאָעל	רפֿאל
רעפֿוע	רפֿואה
רעפֿועס	רפֿואות
רעפֿוע־בדוקע	רפֿואה־בדוקה
רעפֿוע־שליימע	רפֿואה־שלמה
רעצוע	רצועה
רעצועס	רצועות
רעצייעך	רוצח
רעצייעכטע	רוצחטע
רעציכע	רציחה
רעציכעדיק	רציחהדיק
רעציכעדיקער	רציחהדיקער
רעציכעדיקע	רציחהדיקע
רעציכעדיקן	רציחהדיקן
רעקידע	רקידה
רעקייעך	רוקח
רעשאָיִם	רשעים
רעשאָיִם־גמורים	רשעים־גמורים
רעשאַנטע	רשענטע
רעשוס	רשות
רעשוס־האַיאָכעד	רשות־היחיד
רעשוס־האָראַבים	רשות־הרבים
רעשיירן	ראש־עירון
רעשימע	רשימה
רעשימעס	רשימות
רעשכוידעש	ראָש־חודש
רעשכוידעש־געלט	ראָש־חודש־געלט
רעשכוידעש־רעטעכל	ראָש־חודש־רעטעכל
שאָ	שעה
שאָען	שעהען
שאָעס	שעות
שאַאַר	שער
שאַאַר־האָאַשפּע	שער־האַשפּה
שאַאַרע־דמאָעס	שערי־דמעות
שאַאַרע־טפֿילע	שערי־תּפֿילה
שאַאַרע־ראַכמים	שערי־רחמים
שאַבאָסים	שבתים
שאַבייסענאַכט	שבתע־נאַכט
שאַבייסענאַכטס	שבתע־נאַכטס
שאַבעס	שבת
שאַבעסדיק	שבתדיק
שאַבעסדיקער	שבתדיקער
שאַבעסדיקע	שבתדיקע
שאַבעסדיקן	שבתדיקן
שאַבעסדיקס	שבתדיקס
שאַבעס־בריישעס	שבת־בראשית
שאַבעס־גאָיִם	שבת־גויים
שאַבעסגוי	שבת־גוי
שאַבעס־גויע	שבת־גויע
שאַבעס־גויעס	שבת־גויעס
שאַבעס־האַגאָדל	שבת־הגדול
שאַבעס־טשוּווע	שבת־תּשובֿה
שאַבעס־כאַזאָן	שבת־חזון
שאַבעס־ליכט	שבת־ליכט
שאַבעס־מעוואָרכים	שבת־מבֿרכים
שאַבעס־נאַכמו	שבת־נחמו
שאַבעס־קוידעש	שבת־קודש
שאַבעס־שאַבאָסן	שבת־שבתון
שאַבעס־שוּווע	שבת־שובֿה
שאַבעס־שטעך	שבת־שטעך
שאַבעס־שטעפּ	שבת־שטעפּ
שאַבעס־שירע	שבת־שירה
שאַדאַר	שד״ר
שאַדײַ	שדי
שאַדײַ קראַ סאָטן	שדי קרע שׂטן
שאָווע־בעשאָווע	שווה־בשווה
שאָווע־לעקאָלנעפֿעש	שווה־לכּל־נפֿש
שאָווע־קעסעף	שווה־כּסף
שאַוועשעקער	שווא־ושקר
שאַוורירע ברירע רירע רי	שבֿרירי ברירי רירי רי
שאַטיע	שטיא
שאַטכאָנים	שדכנים
שאַטכאָנעס	שדכנות
שאַטכן	שדכן
שאַטכנטע	שדכנטע
שאַטכנטעס	שדכנטעס
שאַטכענען	שדכנען
שאַטנעז	שעטנז
שאַיאָרע	שיירה
שאָכטים	שוחטים
שאָכטעס	שוחטות
שאָכן	שכן
שאָכנס	שכנס
שאָכנטע	שכנטע
שאָכנטעס	שכנטעס
שאָכניי־אָפֿער	שוכן־עפֿר
שאַכנע	שכנא
שאַכרייסים	שחריתים
שאַכרעס	שחרית
שאַלווע	שלווה
שאַלאַכמאָנעס	שלח־מנות
שאָל־טאַכטיס	שאול־תּחתּית
שאָל־טאַכטיִע	שאול־תּחתּיה
שאָלעם	שלום
שאָלעמס	שלומס
שאָלעמען	שלומען
שאָלעם־אַלייכעם	שלום־עליכם
שאָלעם־אַלייכעמס	שלום־עליכמס
שאָלעם־אַלייכעמען	שלום־עליכמען
שאָלעם־באַיִס	שלום־בית
שאָלעם־וועשאַלווע	שלום־ושלווה
שאָלעם־זאָכער	שלום־זכר
שאָלעם־לאַהוּווי	שלום־לאַהובֿי־בריוו
שאָלעש	שליש
שאַלעשודעס	שלש־סעודות
שאָלעש־רעגאָלים	שלש־רגלים
שאַלשעלעס	שלשלת
שאַלשעלעס־האַיאָכסן	שלשלת־היוחסין
שאַמאָסים	שמשׂים
שאַמאָסעס	שמשׂות
שאָ־מוצלאַכעס	שעה־מוצלחת
שאַמײַ	שמאי
שאַמע	שמאי
שאַמעס	שמשׂ
שאַמעסטע	שמשׂטע
שאָמרים	שומרים
שאָמרע־שאַבעס	שומרי־שבת
שאָנים	שנים
שאָנע	שנה
שאָנע	שאָני
שאָנע האָכע	שאָני הכא
שאָנע־טויווע	שנה־טובֿה
שאָנע־מעובערעס	שנה־מעוברת
שאַס	ש״ס
שאַס	שס
שאַסאַ	שס״ה
שאַסאַ גידן	שס״ה גידין
שאַס־האַטכאַק	שעת־הדחק
שאַס־האַקוישער	שעת־הכּושר
שאַסטכינע	ש״ס־תּחינה
שאָסקים	שותקים
שאַס־ראָצן	שעת־רצון
שאָעל	שאָול
שאַפּסע	שבתי
שאַפּסעס	שבתיס
שאַפּסען	שבתין
שאַפּסע־צווי	שבתי־צבֿי
שאַפּסע־צוויניק	שבתי־צבֿיניק
שאָפֿטים	שופֿטים
שאָפֿל	שפֿל
שאַץ	ש״ץ
שאַקלע־וועטאַריע	שקלא־וטריא
שאַקראָנים	שקרנים
שאַקרען	שקרן
שאָר	שור
שאַר־בלאַט	שער־בלאַט
שאָראַבאָר	שור־הבר
שאָר־אַראָצעס	שאָר־אַרצות
שאָר־האַניסקל	שור־הניסקל
שאַרוועט	שרבֿיט
שאָריעראָקעס	שאָר־ירקות
שאָרע־בעצאַאַר	שרוי־בצער
שאַרפּאַט	שרפּ״ט
שבייסענאַכט	שבת־צו־נאַכט
שבייסענאַכטס	שבת־צו־נאַכטס
שוואָ	שוואָ
שוואַט	שבֿט
שוואָטים	שבֿטים
שוואַך	שבֿח
שוואָכים	שבֿחים
שוואָרים	שבֿרים
שוואַרצמייעדיק	שוואַרץ־מאהדיק
שוואַרצמייעניק	שוואַרץ־מאהניק
שוווּע	שבֿועה
שוווּעס	שבֿועות
שוווּעסל	שבֿועתל
שוויִיִ	שבֿיעי
שוויִיִס	שבֿיעית
שוויִיִ־שעל־פּייסעך	שבֿיעי־של־פּסח
שוטעף	שותּף
שוטעפֿטע	שותּפֿטע
שוטעפֿטעס	שותּפֿטעס
שוטפֿים	שותּפֿים
שוטפֿיש	שותּפֿיש
שוטפֿעס	שותּפֿות
שוטפֿעסדיק	שותּפֿותדיק
שויגעג	שוגג
שויטים	שוטים
שויטע	שוטה
שויכן־אָפֿער	שוכן־עפֿר
שויכעד	שוחד
שויכעט	שוחט
שויכעטס	שוחטס
שויכעטקע	שוחטקע
שויכעטקעס	שוחטקעס
שוילעט	שולט
שוימו שאָמאַיִם	שומו שמים
שוימער	שומר
שוימער־אומאַצל	שומר־ומציל
שוימער־ייִסראָעל	שומר־ישׂראל
שוימער־כינעם	שומר־חינם
שוימער־סאָכער	שומר־שׂכר
שוימער־פּסאָיִם	שומר־פּתאָים
שוימער־שאַבעס	שומר־שבת
שויסעק	שותק
שויעל	שואל
שויעלס	שואלס
שויעלן	שואלן
שויעל־אייצע	שואל־עצה
שויפֿעט	שופֿט
שויפֿעך־דאַם	שופֿך־דם
שויפֿעך־דאָמים	שופֿך־דמים
שויפֿער	שופֿר
שויפֿער־שעל־מעשיִעך	שופֿר־של־משיח
שויפֿרעס	שופֿרות
שוירעש	שורש
שוישאַנעס־יאַנקעוו	שושנת־יעקבֿ
שולאַמיס	שולמית
שולכן	שולחן
שולכן־אָרעך	שולחן־ערוך
שום	שום
שופֿרע־דעשופֿרע	שופֿרא־דשופֿרא
שורע	שורה
שורעס	שורות
שורע־גריזל	שורה־גריזל
שורעק	שורק
שושן־האַבירע	שושן־הבירה
שושן־פּורים	שושן־פּורים
שטאַדלאָנים	שתּדלנים
שטאַדלאָנעס	שתּדלנות
שטאַדלען	שתּדלן
שטאַדלענטע	שתּדלנטע
שטאַדלענטעס	שתּדלנטעס
שטאַדלענען	שתּדלנען
שטאָכים	שטחים
שטאָנע	השתּנה
שטאַר	שטר
שטאָרים	שטרים
שטאַר־כאָצי־זאָכער	שטר־חצי־זכר
שטאַרכויוו	שטר־חובֿ
שטאַר־מעכירע	שטר־מכירה
שטאָרעס	שטרות
שטוס	שטות
שטוסים	שטותים
שטוסערײַ	שטותערײַ
שטיִע	שתּיה
שטיִען	שתּיהן
שטיקע	שתּיקה
שטיקע קעהוידאָע	שתּיקה כּהודאה
שטיקע קעהוידאָע דאַמיע	שתּיקה כּהודאה דמיא
שיבושים	שיבושים
שיבעד	שיעבוד
שיבעד־גאָליעס	שיעבוד־גלויות
שיבעש	שיבוש
שיגאָנען	שגעונען
שיגאָען	שגעון
שיגוינעס	שגעונות
שידוכים	שידוכים
שידע	שידה
שידעך	שידוך
שיוואָסער־בעטאַמעז	שיבֿעה־עשׂר־בתּמוז
שיווים	שיבֿעים
שיווים־אומעס	שיבֿעים־אומות
שיווים־לאָשן	שיבֿעים־לשון
שיווים־לעשוינעס	שיבֿעים־לשונות
שיוויסי	שויתי
שיוויסי אַדוישעם לענעגדי טאָמעד	שויתי ה׳ לנגדי תּמיד
שיווע	שיבֿעה
שיווע־טוּווע־האָיִר	שיבֿעה־טובֿי־העיר
שיווע־יאַמים	שיבֿעה־ימים
שיווע־יאַמען	שיבֿעה־ימים
שיווע־מעדורע־גענעם	שיבֿעה־מדורי־גיהנום
שיוועס־יעמיי־האַמישטע	שיבֿעת־ימי־המישתּה
שיוועס־ציִען	שיבֿת־ציון
שיוורע־לוכעס	שיבֿרי־לוחות
שיוורעלעוו	שיבֿרי־לבֿ
שיוורעס־האַלעוו	שיבֿרות־הלבֿ
שיוורע־קיילע	שיבֿרי־כּלי
שיִורים	שיעורים
שיטין־נישמין	שיתּין־נשמין
שיטע	שיטה
שיטעס	שיטות
שײַ	ש״י
שײַ אוילאָמעס	ש״י עולמות
שײַ אוילעמעס	ש״י עולמות
שײַגעס־אַריע	שאגת־אַריה
שייגעץ	שייגעץ
שיידים	שדים
שייווע	שווא
שייוועט	שבֿט
שײַכעס	שײַכות
שײַלע	שאלה
שײַלעס	שאלות
שײַלעס־אוטשוּוועס	שאלות־ותּשובֿות
שײַלעס־האָרייע	שאלת־הריאה
שײַלעס־טשוּווע	שאלת־תּשובֿה
שײַלעס־טשוּוועס	שאלות־תּשובֿות
שײַלעס־נאָשים	שאלת־נשים
שיימע	שיימע
שיימעס	שיימעס
שיימעס	שמות
שייניס	שנית
שײַנע	הושענא
שיינע־לעמאַלכעס	שני־למלכות
שיינע־לעמיילעך	שני־למלך
שיינעס	שנית
שײַנע־ראַבע	הושענא־רבה
שיינע־שעבעשלישי	שני־שבשלישי
שײַע	שעיה
שײַעס	שעיהס
שײַען	שעיהן
שײַעך	שייך
שיירבאָסער	שאר־בשׂר
שיירעס	שארית
שיירעס־האַפּלייטע	שארית־הפּליטה
שיישעס־יעמיי־בריישעס	ששת־ימי־בראשית
שילעמען	שילמען
שילשל	שילשול
שימען	שמעון
שימענס	שמעונס
שימענען	שמעונען
שימען באַר־יעכײַ	שמעון בר־יוחאי
שימענעסרע	שמונה־עשׂרה
שימשן	שמשון
שימשנס	שמשונס
שימשן האַגיבער	שמשון הגיבור
שימשן האַגיבערס	שמשון הגיבורס
שין	ש
שין	שין
שינויִם	שינויים
שינע	שינוי
שינע־מאָקעם	שינוי־מקום
שינעשעם	שינוי־שם
שיִעס	שהיות
שיִע־פּיִע	שהי־פּהי
שיִער	שיעור
שיפּויִם	שיפּועים
שיפּוע	שיפּוע
שיפֿכע	שיפֿחה
שיפֿכע־באַלשעמטאָוו	שבֿחי־בעל־שם־טובֿ
שיפֿכע־האַבעשט	שבֿחי־הבעש״ט
שיפֿלעס	שיפֿלות
שיפֿרע	שפֿרה
שיפֿרעס	שפֿרהס
שיפֿרען	שפֿרהן
שיפֿרעלע	שפֿרהלע
שיפֿרעלעס	שפֿרהלעס
שיפֿרעלען	שפֿרהלען
שיקאָרניצע	שכּורניצע
שיקאָרניק	שכּורניק
שיקורים	שיכּורים
שיקכע	שיכּחה
שיקעץ־מעשוימעם	שיקוץ־משומם
שיקער	שיכּור
שיקערערהייט	שיכּורערהייט
שיקערס	שיכּורס
שיקערטע	שיכּורטע
שיקערטעס	שיכּורטעס
שיקערן	שיכּורן
שיקערסט	שיכּורסט
שיקערט	שיכּורט
געשיקערט	געשיכּורט
שיקרעס	שיכּרות
שיקרעס	שיקרות
שיר	שיר
שיראַיִם	שיריים
שיר־אַמײַלעס	שיר־המעלות
שיר־האַמײַלעס	שיר־המעלות
שיר־אַשירים	שיר־השירים
שיר־האַשירים	שיר־השירים
שירים־וועטישבאָכעס	שירים־ותּשבחות
שירע	שירה
שישי	שישי
שישים	שישים
שישים ריבוי	שישים ריבוא
שישע־ניירעס	שישה־נרות
שישע סדאָרים	שישה סדרים
שישע סעדאָרים	שישה סדרים
שכיוומעראַ	שכיבֿ־מרע
שכיטע	שחיטה
שכיטעס	שחיטות
שכיטעס־כולין	שחיטת־חולין
שכיטעס־כוץ	שחיטת־חוץ
שכיינים	שכנים
שכייניש	שכניש
שכיינע	שכנה
שכיינעס	שכנהס
שכיינעס	שכנות
שכיינעסדיק	שכנותדיק
שכין	שחין
שכינע	שכינה
שכיִעך	שכיח
שלאַך	שלח
שלאַכמאָנעס	שלח־מנות
שלאַל	שלל
שלאָסמעם	שלאָס־מם
שלוימע	שלמה
שלוימעס	שלמהס
שלוימען	שלמהן
שלוימעלע	שלמהלע
שלוימעלעס	שלמהלעס
שלוימעלען	שלמהלען
שלוימע האַמיילעך	שלמה המלך
שלוימע האַמיילעכס	שלמה המלכס
שלוישים	שלושים
שלוישע־דוואָרים	שלשה־דבֿרים
שלוישעס־יעמיי־האַגבאָלע	שלשת־ימי־הגבלה
שלוכים	שליחים
שלוכים־מעיוכאָדים	שליחים־מיוחדים
שלוכע־דעראַבאָנען	שלוחא־דרבנן
שלוכע־ציבער	שליחי־ציבור
שלומיִעל	שלומיאל
שליטע	שליט״א
שליטע	שליטה
שליימעס	שלמות
שליכים	שליחים
שליכים־מעיוכאָדים	שליחים־מיוחדים
שליכעס	שליחות
שליכע־ציבער	שליחי־ציבור
שלימאַזל	שלימזל
שלימעזאַלניצע	שלימזלניצע
שלימעזאַלניק	שלימזלניק
שלימ־שלימאַזל	שלים־שלימזל
שלישי	שלישי
שלישים	שלישים
שלישעס	שלישות
שמאַד	שמד
שמאַדיש	שמדיש
שמאַדן	שמדן
געשמאַט	געשמדט
שמאַדניצע	שמדניצע
שמאַדניק	שמדניק
שמאַדעלניצע	שמדעלניצע
שמאַדעלניק	שמדעלניק
שמאַדקייט	שמדקייט
שמאַטשטיק	שמד־שטיק
שמאַ־ייִסראָעל	שמע־ישׂראל
שמאַ־קויליינו	שמע־קולנו
שמאַקעליינע	שמע־קולנו
שמאַריע	שמריה
שמאַריעס	שמריהס
שמאַריען	שמריהן
שמאַריע	שמריהו
שמאַריעס	שמריהוס
שמאַריען	שמריהון
שמוינים	שמונים
שמוינע	שמונה
שמויס	שמות
שמויס־האַטומע	שמות־הטומאה
שמוע	שמועה
שמועס	שמועות
שמועל	שמואל
שמועל האַנאָווי	שמואל הנבֿיא
שמורע	שמורה
שמורעמאַצע	שמורה־מצה
שמורעניק	שמורהניק
שמיטע	שמיטה
שמײַע	שמעיה
שמײַען	שמעיהן
שמינאַצערעס	שמיני־עצרת
שמיני	שמיני
שמיניס־שעבעשמיניס	שמינית־שבשמינית
שמיִע	שמיעה
שמירע	שמירה
שנאָדערן	שנדרן
שנאַיִם	שנים
שנאַס	שנת
שנאַס־באַצוירעס	שנת־בצורת
שניי	שני
שניי לוכעס האַבריס	שני לוחות הברית
שנייער	שניאור
שע…	ש…
שעאָרים	שערים
שעבאַ…	שב…
שעבאַלפּע	שבעל־פּה
שעביקסאַוו	שבכּתבֿ
שעבע…	שב…
שעד	שד
שעדעכע	שדיכע
שעהאַקל	שהכּל
שעוואַך	שבֿח
שעווע	שבֿע
שעוועס	שבֿעס
שעווען	שבֿען
שעווע־בראָכעס	שבֿע־ברכות
שעווע־בראָכעס	שבֿע־ברכות
שעוועך	שבֿח
שעווע־כאָכמעס	שבֿע־חכמות
שעוועס־אַכים	שבֿת־אַחים
שעווער	שבֿר
שעטיכיע	שתּחיה
שעטעך	שטח
שעייִכיע לעוירעך יאָמים טויווים אָמיין	שיחיה לאורך ימים טובֿים אָמן
שעיין מאַקירן	שאין מכּירין
שעיינע־יעדייע־לישויל	שאינו־יודע־לשאול
שעיין קויכעם עלאָ בעפֿיהעם	שאין כּוחם אלא בפֿיהם
שעכטן	שחטן
שעכעיאָנו	שהחיינו
שעל	של
שעלאַ	של״ה
שעלאַ־האַקאָדעש	של״ה־הקדוש
שעלאָך	שלך
שעלוי	שלא־
שעלוי־לעווײַעש	שלא־לבֿייש
שעלוי־מין־האַייִשעוו	שלא־מן־הישובֿ
שעלוי־קעדערעך־האַטעווע	שלא־כּדרך־הטבֿע
שעלי	שלי
שעליאַד	של־יד
שעליטע	שליט״א
שעליִעך	שליח
שעליִעך־מעיוכעד	שליח־מיוחד
שעליִעך־ציבער	שליח־ציבור
שעלי שעלאָך שעלכאָ שעלי	שלי שלך שלך שלי
שעלי שעלי שעלכאָ שעלאָך	שלי שלי שלך שלך
שעלכאָ	שלך
שעלראָש	של־ראָש
שעם	שם
שעמאַ	שמא
שעמדאָווער	שם־דבֿר
שעם־האַווײַע	שם־הוויה
שעם־האַמפֿוירעש	שם־המפֿורש
שעמטאָוו	שם־טובֿ
שעמען	שמען
שעמען־זאַיִס	שמן־זית
שעמען־זאַיִסדיק	שמן־זיתדיק
שעמעץ	שמץ
שעמראַ	שם־רע
שענאָדערן	שנדרן
שעסאַ	שס״ה
שעסאַ גידן	שס״ה גידין
שעסי־וואָערעוו	שתי־וערבֿ
שעפֿע	שפֿע
שעקל	שקל
שעקער	שקר
שעקער־וועקאָזעוו	שקר־וכּזבֿ
שעקער־וועשלימאַזל	שקר־ושלימזל
שעראָשים	שורשים
שערעץ	שרץ
שפֿויכאַמאָסכע	שפֿוך־חמתך
שפֿויך־כאַמאָסכאָ	שפֿוך־חמתך
שפֿיכעס־דאָמים	שפֿיכת־דמים
שקאָלים	שקלים
שקאָץ	שקאָץ
שקאָצים	שקאָצים
שקאָצים	שקצים
שקאָרים	שקרים
שקאָרים־אוכזאָווים	שקרים־וכזבֿים
שקויעך	יישר־כּוח
שקיִע	שקיעה
שקיִעס־האַכאַמע	שקיעת־החמה
שראַגע	שרגא
שראָצים	שרצים
שרוּיע	שרויה